"id","countyfips","year","births","censusbuildingpermits","deaths","groupquarterspopulation","householdpopulation","households","householdsize","naturalincrease","netmigration","totalhousingunits","vacancyrate","vacanthousingunits","totalpopulation"
"1",0,1985,"55115","30898","20234","81139","3133309","1221557","2.57","34881","5317","1402558","12.9","181001","3214448"
"2",0,1986,"55142","30280","20768","82109","3161694","1243453","2.54","34374","-5731","1436610","13.5","193157","3243803"
"3",0,1987,"53803","17449","21089","83419","3179935","1258199","2.53","32714","-14299","1467981","14.3","209782","3263354"
"4",0,1988,"53346","12371","21312","86810","3184638","1267288","2.51","32034","-24046","1486346","14.7","219058","3271448"
"5",0,1989,"52697","10740","21056","87671","3196866","1282386","2.49","31641","-18698","1497046","14.3","214660","3284537"
"6",0,1990,"53491","11388","21514","79551","3224491","1282488","2.51","31977","-12584","1477349","13.2","194861","3304042"
"7",0,1991,"53530","13450","22096","81719","3299232","1313504","2.51","31434","45475","1488886","11.8","175382","3380951"
"8",0,1992,"54545","23057","22426","84669","3405163","1354139","2.51","32119","76762","1503198","9.9","149059","3489832"
"9",0,1993,"54100","29791","23171","89323","3515715","1386998","2.53","30929","84277","1527392","9.2","140394","3605038"
"10",0,1994,"53788","36748","23828","90658","3621404","1418294","2.55","29960","77064","1557549","8.9","139255","3712062"
"11",0,1995,"53869","38618","24724","93604","3717470","1451449","2.56","29145","69867","1594454","9","143005","3811074"
"12",0,1996,"54974","41135","25083","99958","3802490","1483877","2.56","29891","61483","1634373","9.2","150496","3902448"
"13",0,1997,"56305","43052","25885","96858","3899065","1527884","2.55","30420","63055","1675928","8.8","148044","3995923"
"14",0,1998,"57738","51156","26297","99083","4003408","1560722","2.57","31441","75127","1719248","9.2","158526","4102491"
"15",0,1999,"60718","49313","26532","106333","4109651","1607300","2.56","34186","79307","1779663","9.7","172363","4215984"
"16",0,2000,"63917","54596","26997","102749","4236052","1674523","2.53","36920","85875","1835015","8.8","160492","4338801"
"17",0,2001,"66525","52872","27934","104464","4340049","1717669","2.53","38591","67121","1888179","9","170510","4444513"
"18",0,2002,"67778","53348","28833","105962","4398747","1743164","2.52","38945","21251","1940772","10.2","197610","4504709"
"19",0,2003,"69012","46521","28950","106969","4448115","1764982","2.52","40062","10313","1991916","11.4","226932","4555084"
"20",0,2004,"68452","38609","29025","108262","4500549","1788148","2.52","39427","14300","2034030","12.1","245882","4608811"
"21",0,2005,"69031","45307","29087","108525","4554009","1811477","2.51","39944","13779","2080634","12.9","269157","4662534"
"22",0,2006,"69538","44188","29308","111028","4634632","1845956","2.51","40230","42896","2122727","13","276771","4745660"
"23",0,2007,"70777","36353","29653","111911","4709873","1879158","2.51","41124","35000","2159545","13","280388","4821784"
"24",0,2008,"70733","27917","31048","112860","4789078","1914596","2.5","39685","40469","2184314","12.4","269718","4901938"
"25",0,2009,"69135","18191","30487","113459","4863394","1947695","2.5","38648","36267","2203007","11.6","255313","4976853"
"26",0,2010,"67306","2339","31396","116952","4933380","1981010","2.49","35910","37569","2218698","10.7","237688","5050332"
"27",0,2011,"65923","11928","32017","117986","5006157","2010004","2.49","33906","39905","2230493","9.9","220489","5124143"
"28",0,2012,"64733","12580","32764","116930","5079042","2039041","2.49","31969","39860","2242975","9.1","203934","5195972"
"29",0,2013,"64735","23347","33624","117855","5154807","2067763","2.49","31111","45579","2265392","8.7","197629","5272662"
"30",0,2014,"65711","27711","34003","117692","5234596","2097309","2.5","31708","47918","2291806","8.5","194497","5352288"
"31",0,2015,"66339","29280","36244","119884","5334112","2131531","2.5","30095","71613","2320695","8.2","189164","5453996"
"32",0,2016,"66561","31937","36820","119832","5422379","2162686","2.51","29741","58474","2349438","7.9","186752","5542211"
"33",0,2017,"65312","37680","37747","121328","5494404","2193797","2.5","27565","45956","2386170","8.1","192373","5615732"
"34",0,2018,"63780","40026","38219","121558","5575339","2226172","2.5","25561","55604","2426935","8.3","200763","5696897"
"35",0,2019,"62456","42627","38645","121328","5642648","2254405","2.5","23811","43268","2467730","8.6","213325","5763976"
"36",1,1985,"5210","2741","1304","2256","266508","94949","2.81","3906","-807","104376","9","9427","268764"
"37",1,1986,"5101","2926","1425","2254","266389","95759","2.78","3676","-3797","108677","11.9","12918","268643"
"38",1,1987,"5058","943","1540","2261","267062","96564","2.77","3518","-2838","111852","13.7","15288","269323"
"39",1,1988,"5024","432","1486","2187","266832","97064","2.75","3538","-3842","112933","14.1","15869","269019"
"40",1,1989,"4777","397","1429","2249","264522","96879","2.73","3348","-5596","113086","14.3","16207","266771"
"41",1,1990,"4807","335","1561","2727","262981","96353","2.73","3246","-4309","106947","9.9","10594","265708"
"42",1,1991,"4940","658","1639","2776","270848","98326","2.75","3301","4615","107282","8.4","8956","273624"
"43",1,1992,"5005","1385","1619","2844","278541","101116","2.75","3386","4375","108074","6.4","6958","281385"
"44",1,1993,"5034","2439","1693","2880","287897","102836","2.8","3341","6051","109367","6","6531","290777"
"45",1,1994,"4906","2906","1800","2963","297831","105211","2.83","3106","6911","111800","5.9","6589","300794"
"46",1,1995,"5063","2944","1781","2979","309614","108485","2.85","3282","8517","114742","5.5","6257","312593"
"47",1,1996,"5251","2764","1844","3774","319268","111208","2.87","3407","7042","117691","5.5","6483","323042"
"48",1,1997,"5480","4155","1872","3798","328946","114514","2.87","3608","6094","120682","5.1","6168","332744"
"49",1,1998,"5846","4478","2053","3795","340229","117449","2.9","3793","7487","124925","6","7476","344024"
"50",1,1999,"6155","4146","2081","3792","351516","120316","2.92","4074","7210","129403","7","9087","355308"
"51",1,2000,"6869","1455","2115","3414","348321","124088","2.81","4754","-8328","128717","3.6","4629","351735"
"52",1,2001,"7132","5819","2223","3396","356041","126724","2.81","4909","2793","133917","5.4","7193","359437"
"53",1,2002,"7271","6158","2213","3625","367556","130680","2.81","5058","6686","139734","6.5","9054","371181"
"54",1,2003,"7393","5981","2283","3649","374016","132793","2.82","5110","1374","144635","8.2","11842","377665"
"55",1,2004,"7429","4811","2216","3643","382302","135443","2.82","5213","3067","149648","9.5","14205","385945"
"56",1,2005,"7560","5313","2357","3626","391758","138478","2.83","5203","4236","154113","10.2","15635","395384"
"57",1,2006,"7733","4928","2241","3657","403930","142496","2.83","5492","6711","157948","9.8","15452","407587"
"58",1,2007,"7841","3252","2279","3671","412244","145208","2.84","5562","2766","160651","9.6","15443","415915"
"59",1,2008,"7925","2288","2448","3683","421455","148306","2.84","5477","3746","162115","8.5","13809","425138"
"60",1,2009,"7699","957","2359","3873","432450","152045","2.84","5340","5845","162794","6.6","10749","436323"
"61",1,2010,"7436","131","2474","4027","439684","154505","2.85","4962","2426","163435","5.5","8930","443711"
"62",1,2011,"7247","666","2467","4042","448166","157466","2.85","4780","3717","164066","4","6600","452208"
"63",1,2012,"6923","717","2754","4019","456520","160378","2.85","4169","4162","164805","2.7","4427","460539"
"64",1,2013,"7171","1043","2798","4029","465967","163585","2.85","4373","5084","165879","1.4","2294","469996"
"65",1,2014,"7044","1550","2711","4135","475937","165375","2.88","4333","5743","167270","1.1","1895","480072"
"66",1,2015,"7361","1575","2962","4130","486432","165330","2.94","4399","6091","168727","2","3397","490562"
"67",1,2016,"7171","1481","2942","4301","493706","165721","2.98","4229","3216","170044","2.5","4323","498007"
"68",1,2017,"7167","2531","3113","4273","499617","168956","2.96","4054","1829","172755","2.2","3799","503890"
"69",1,2018,"6916","2667","3128","4273","507434","172361","2.94","3788","4029","175843","2","3482","511707"
"70",1,2019,"6719","3002","3170","4273","513612","176427","2.91","3549","2629","178987","1.4","2560","517885"
"71",3,1985,"258","10","79","884","12127","4277","2.84","179","-85","5113","16.4","836","13011"
"72",3,1986,"246","16","84","897","12439","4388","2.83","162","163","5117","14.3","729","13336"
"73",3,1987,"273","11","90","900","12527","4412","2.84","183","-92","5126","13.9","714","13427"
"74",3,1988,"264","60","99","1168","12547","4394","2.86","165","123","5147","14.6","753","13715"
"75",3,1989,"234","28","103","1153","12507","4375","2.86","131","-186","5293","17.3","918","13660"
"76",3,1990,"265","29","91","998","12632","4721","2.68","174","-204","5254","10.1","533","13630"
"77",3,1991,"273","20","95","967","12672","4860","2.61","178","-169","5283","8","423","13639"
"78",3,1992,"273","33","84","1063","12509","4931","2.54","189","-256","5303","7","372","13572"
"79",3,1993,"228","73","98","817","12840","4983","2.58","130","-45","5357","7","374","13657"
"80",3,1994,"218","45","98","550","13273","5147","2.58","120","46","5430","5.2","283","13823"
"81",3,1995,"230","9","126","929","13168","5200","2.53","104","170","5475","5","275","14097"
"82",3,1996,"236","68","119","795","13527","5391","2.51","117","108","5651","4.6","260","14322"
"83",3,1997,"235","89","124","876","13602","5500","2.47","111","45","5719","3.8","219","14478"
"84",3,1998,"242","100","100","916","13707","5603","2.45","142","3","5808","3.5","205","14623"
"85",3,1999,"203","78","114","956","13866","5700","2.43","89","110","6019","5.3","319","14822"
"86",3,2000,"231","13","106","995","14104","5523","2.55","125","149","6146","10.1","623","15099"
"87",3,2001,"249","52","113","995","14236","5598","2.54","136","-4","6200","9.7","602","15231"
"88",3,2002,"227","92","116","995","14271","5636","2.53","111","-76","6246","9.8","610","15266"
"89",3,2003,"220","48","131","995","14365","5697","2.52","89","5","6299","9.6","602","15360"
"90",3,2004,"271","35","101","995","14411","5741","2.51","170","-124","6350","9.6","609","15406"
"91",3,2005,"260","53","115","995","14400","5757","2.5","145","-156","6392","9.9","635","15395"
"92",3,2006,"227","64","93","995","14355","5761","2.49","134","-179","6417","10.2","656","15350"
"93",3,2007,"263","48","114","995","14298","5763","2.48","149","-206","6462","10.8","699","15293"
"94",3,2008,"258","54","109","995","14351","5808","2.47","149","-96","6510","10.8","702","15346"
"95",3,2009,"272","56","89","995","14306","5814","2.46","183","-228","6536","11.1","722","15301"
"96",3,2010,"250","8","127","740","14734","6008","2.45","123","50","6561","8.4","553","15474"
"97",3,2011,"234","38","131","740","14929","6086","2.45","103","92","6598","7.8","512","15669"
"98",3,2012,"208","53","118","740","14903","6077","2.45","90","-116","6650","8.6","573","15643"
"99",3,2013,"223","73","146","740","15010","6121","2.45","77","30","6722","8.9","601","15750"
"100",3,2014,"240","50","126","865","14906","6078","2.45","114","-93","6776","10.3","698","15771"
"101",3,2015,"215","56","128","865","15008","6120","2.45","87","15","6843","10.6","723","15873"
"102",3,2016,"200","26","141","865","15170","6186","2.45","59","103","6878","10.1","692","16035"
"103",3,2017,"197","75","157","865","15229","6213","2.45","40","19","6958","10.7","745","16094"
"104",3,2018,"200","87","138","865","15360","6266","2.45","62","69","7048","11.1","782","16225"
"105",3,2019,"192","44","144","865","15316","6249","2.45","48","-92","7091","11.9","842","16181"
"106",5,1985,"6458","5069","1602","3536","377708","140787","2.68","4856","9246","153726","8.4","12939","381244"
"107",5,1986,"6414","4020","1693","3586","383658","144013","2.66","4721","1279","159313","9.6","15300","387244"
"108",5,1987,"6269","2060","1665","3604","385083","145014","2.66","4604","-3161","163322","11.2","18308","388687"
"109",5,1988,"6269","1804","1723","3787","382936","144805","2.64","4546","-6510","165411","12.5","20606","386723"
"110",5,1989,"6200","558","1712","3666","385836","146698","2.63","4488","-1709","166846","12.1","20148","389502"
"111",5,1990,"6163","637","1829","3112","390172","154710","2.52","4334","-552","168665","8.3","13955","393284"
"112",5,1991,"6404","1027","1909","3207","399995","159542","2.51","4495","5423","169302","5.8","9760","403202"
"113",5,1992,"6551","2277","1970","3311","414370","165029","2.51","4581","9898","170329","3.1","5300","417681"
"114",5,1993,"6407","2905","2036","3383","424087","168215","2.52","4371","5418","172532","2.5","4317","427470"
"115",5,1994,"6250","4198","2223","3196","433209","171232","2.53","4027","4908","175437","2.4","4205","436405"
"116",5,1995,"6231","3408","2289","3211","439328","173806","2.53","3942","2192","179635","3.2","5829","442539"
"117",5,1996,"6343","3585","2281","3190","447875","177697","2.52","4062","4464","183260","3","5563","451065"
"118",5,1997,"6166","3932","2475","2265","456793","182703","2.5","3691","4302","186853","2.2","4150","459058"
"119",5,1998,"6504","4234","2534","2243","470156","187217","2.51","3970","9371","190785","1.9","3568","472399"
"120",5,1999,"6905","5437","2641","3283","478023","191571","2.5","4264","4643","195845","2.2","4274","481306"
"121",5,2000,"7111","1725","2711","4847","485875","192016","2.53","4400","5015","198605","3.3","6589","490722"
"122",5,2001,"7526","6900","2909","5193","496478","196308","2.53","4617","6332","202264","2.9","5956","501671"
"123",5,2002,"7553","7017","2932","5406","505097","199890","2.53","4621","4211","208601","4.2","8711","510503"
"124",5,2003,"8031","3915","2914","5621","510733","202072","2.53","5117","734","213840","5.5","11768","516354"
"125",5,2004,"8013","2727","2884","5851","517864","204867","2.53","5129","2232","217147","5.7","12280","523715"
"126",5,2005,"8088","3070","3014","5643","522571","206663","2.53","5074","-575","221982","6.9","15319","528214"
"127",5,2006,"8036","3162","2934","5433","530618","209780","2.53","5102","2735","226156","7.2","16376","536051"
"128",5,2007,"8233","2711","3118","5917","539965","213407","2.53","5115","4716","230285","7.3","16878","545882"
"129",5,2008,"8292","3023","3207","5773","550473","217507","2.53","5085","5279","233100","6.7","15593","556246"
"130",5,2009,"8124","1445","3182","5605","560875","220854","2.54","4942","5292","236200","6.5","15346","566480"
"131",5,2010,"7981","278","3295","4920","569899","225106","2.53","4686","3653","239172","5.9","14066","574819"
"132",5,2011,"7707","1254","3422","4797","581143","229553","2.53","4285","6836","240398","4.5","10845","585940"
"133",5,2012,"7747","334","3382","4764","591735","233819","2.53","4365","6194","240700","2.9","6881","596499"
"134",5,2013,"7821","1318","3555","4547","603715","237438","2.54","4266","7497","241947","1.9","4509","608262"
"135",5,2014,"7906","2749","3487","4526","614306","241285","2.55","4419","6151","244783","1.4","3498","618832"
"136",5,2015,"8130","1458","3750","4323","626276","244583","2.56","4380","7387","246706","0.9","2123","630599"
"137",5,2016,"8094","2016","3925","4275","634238","246021","2.58","4169","3745","248567","1","2546","638513"
"138",5,2017,"7855","4311","3957","4275","639813","250120","2.56","3898","1677","252820","1.1","2700","644088"
"139",5,2018,"7687","2688","3973","4275","647435","253104","2.56","3714","3908","255249","0.8","2145","651710"
"140",5,2019,"7548","3319","3974","4275","652547","255165","2.56","3574","1538","257943","1.1","2778","656822"
"141",7,1985,"101","9","22","0","5213","1837","2.84","79","149","3379","45.6","1542","5213"
"142",7,1986,"96","121","40","0","5335","1896","2.81","56","66","3635","47.8","1739","5335"
"143",7,1987,"88","104","30","0","5265","1884","2.79","58","-128","3869","51.3","1985","5265"
"144",7,1988,"91","116","42","0","5004","1802","2.78","49","-310","3979","54.7","2177","5004"
"145",7,1989,"84","68","35","0","5196","1885","2.76","49","143","4082","53.8","2197","5196"
"146",7,1990,"85","72","30","0","5393","2010","2.68","55","142","3951","49.1","1941","5393"
"147",7,1991,"73","63","36","0","5626","2076","2.71","37","196","4023","48.4","1947","5626"
"148",7,1992,"70","107","25","0","5880","2147","2.74","45","209","4086","47.5","1939","5880"
"149",7,1993,"62","101","35","0","6177","2324","2.66","27","270","4193","44.6","1869","6177"
"150",7,1994,"77","189","34","0","6539","2456","2.66","43","319","4294","42.8","1838","6539"
"151",7,1995,"61","248","36","0","7108","2671","2.66","25","544","4483","40.4","1812","7108"
"152",7,1996,"77","249","36","0","7928","2987","2.65","41","779","4731","36.9","1744","7928"
"153",7,1997,"99","243","48","0","8534","3239","2.63","51","555","4980","35","1741","8534"
"154",7,1998,"84","308","41","0","9133","3452","2.65","43","556","5223","33.9","1771","9133"
"155",7,1999,"106","271","56","0","9570","3619","2.64","50","387","5536","34.6","1917","9570"
"156",7,2000,"104","87","56","84","9959","4047","2.46","48","425","6302","35.8","2255","10043"
"157",7,2001,"112","350","60","84","10381","4252","2.44","52","370","6667","36.2","2415","10465"
"158",7,2002,"126","284","58","84","10616","4384","2.42","68","167","6967","37.1","2583","10700"
"159",7,2003,"118","365","57","84","10880","4529","2.4","61","203","7350","38.4","2821","10964"
"160",7,2004,"129","213","64","84","11087","4654","2.38","65","142","7582","38.6","2928","11171"
"161",7,2005,"109","234","62","84","11318","4790","2.36","47","184","7836","38.9","3046","11402"
"162",7,2006,"105","247","62","84","11714","4999","2.34","43","353","8104","38.3","3105","11798"
"163",7,2007,"150","302","78","84","12024","5173","2.32","72","238","8428","38.6","3255","12108"
"164",7,2008,"130","202","76","84","11990","5204","2.3","54","-88","8652","39.9","3448","12074"
"165",7,2009,"111","147","94","84","11815","5171","2.28","17","-192","8714","40.7","3543","11899"
"166",7,2010,"108","10","63","129","11931","5257","2.27","45","116","8772","40.1","3515","12060"
"167",7,2011,"137","37","82","129","11906","5246","2.27","55","-80","8818","40.5","3572","12035"
"168",7,2012,"116","36","72","129","12019","5295","2.27","44","69","8870","40.3","3575","12148"
"169",7,2013,"106","53","92","129","12104","5332","2.27","14","71","8929","40.3","3597","12233"
"170",7,2014,"109","70","94","129","12121","5340","2.27","15","2","9015","40.8","3675","12250"
"171",7,2015,"118","75","101","129","12279","5410","2.27","17","141","9095","40.5","3685","12408"
"172",7,2016,"117","113","91","129","12714","5600","2.27","26","409","9203","39.2","3603","12843"
"173",7,2017,"136","131","107","129","13185","5808","2.27","29","442","9335","37.8","3527","13314"
"174",7,2018,"118","173","105","129","13605","5993","2.27","13","407","9507","37","3514","13734"
"175",7,2019,"106","162","104","129","13873","6111","2.27","2","266","9679","36.9","3568","14002"
"176",9,1985,"83","1","62","0","4873","1867","2.61","21","-195","2581","27.7","714","4873"
"177",9,1986,"57","0","56","0","4587","1768","2.59","1","-287","2603","32.1","835","4587"
"178",9,1987,"74","1","48","0","4559","1763","2.59","26","-54","2625","32.8","862","4559"
"179",9,1988,"76","1","64","0","4728","1836","2.58","12","157","2630","30.2","794","4728"
"180",9,1989,"51","3","52","0","4629","1807","2.56","-1","-98","2587","30.2","780","4629"
"181",9,1990,"61","1","58","74","4452","1872","2.38","3","-106","2434","23.1","562","4526"
"182",9,1991,"55","3","49","70","4371","1787","2.45","6","-91","2435","26.6","648","4441"
"183",9,1992,"42","4","58","71","4231","1794","2.36","-16","-123","2438","26.4","644","4302"
"184",9,1993,"33","3","56","71","4255","1776","2.4","-23","47","2442","27.3","666","4326"
"185",9,1994,"54","7","54","71","4320","1790","2.41","0","65","2445","26.8","655","4391"
"186",9,1995,"44","4","56","72","4356","1808","2.41","-12","49","2452","26.3","644","4428"
"187",9,1996,"58","5","58","74","4452","1855","2.4","0","98","2456","24.5","601","4526"
"188",9,1997,"49","10","58","74","4488","1884","2.38","-9","45","2461","23.5","577","4562"
"189",9,1998,"53","18","69","74","4457","1873","2.38","-16","-15","2471","24.2","598","4531"
"190",9,1999,"42","10","63","74","4449","1873","2.38","-21","13","2489","24.8","616","4523"
"191",9,2000,"55","2","74","85","4414","1901","2.32","-19","-4","2360","19.5","459","4499"
"192",9,2001,"41","7","67","85","4362","1888","2.31","-26","-26","2352","19.7","464","4447"
"193",9,2002,"40","7","64","85","4230","1841","2.3","-24","-108","2342","21.4","501","4315"
"194",9,2003,"35","7","62","85","4173","1827","2.28","-27","-30","2333","21.7","506","4258"
"195",9,2004,"26","10","53","85","4081","1795","2.27","-27","-65","2327","22.9","532","4166"
"196",9,2005,"38","9","56","85","4013","1780","2.25","-18","-50","2317","23.2","537","4098"
"197",9,2006,"37","1","62","85","4003","1784","2.24","-25","15","2301","22.5","517","4088"
"198",9,2007,"44","0","70","85","3908","1752","2.23","-26","-69","2287","23.4","535","3993"
"199",9,2008,"45","1","62","85","3821","1721","2.22","-17","-70","2273","24.3","552","3906"
"200",9,2009,"38","0","69","85","3729","1689","2.21","-31","-61","2257","25.2","568","3814"
"201",9,2010,"39","0","52","82","3713","1687","2.2","-13","-6","2248","25","561","3795"
"202",9,2011,"41","2","73","82","3688","1679","2.2","-32","7","2250","25.4","571","3770"
"203",9,2012,"53","2","72","82","3629","1650","2.2","-19","-40","2252","26.7","602","3711"
"204",9,2013,"48","0","54","82","3565","1621","2.2","-6","-58","2252","28","631","3647"
"205",9,2014,"37","0","49","82","3496","1588","2.2","-12","-57","2252","29.5","664","3578"
"206",9,2015,"32","0","56","82","3465","1575","2.2","-24","-7","2252","30.1","677","3547"
"207",9,2016,"38","0","63","82","3443","1567","2.2","-25","3","2252","30.4","685","3525"
"208",9,2017,"39","1","45","82","3464","1523","2.27","-6","27","2253","32.4","730","3546"
"209",9,2018,"35","0","61","82","3472","1578","2.2","-26","34","2253","30","675","3554"
"210",9,2019,"47","0","51","82","3474","1580","2.2","-4","6","2253","29.9","673","3556"
"211",11,1985,"80","6","64","424","5275","1986","2.66","16","-155","2532","21.6","546","5699"
"212",11,1986,"56","2","66","427","5302","2013","2.63","-10","40","2548","21","535","5729"
"213",11,1987,"65","7","55","407","5025","1923","2.61","10","-307","2561","24.9","638","5432"
"214",11,1988,"76","3","71","405","5027","1938","2.59","5","-5","2571","24.6","633","5432"
"215",11,1989,"64","1","48","331","4879","1895","2.57","16","-238","2574","26.4","679","5210"
"216",11,1990,"60","2","67","372","4655","1865","2.5","-7","-176","2332","20","467","5027"
"217",11,1991,"59","1","66","366","4594","1836","2.5","-7","-60","2334","21.3","498","4960"
"218",11,1992,"48","2","51","369","4671","1853","2.52","-3","83","2335","20.6","482","5040"
"219",11,1993,"63","5","43","603","4747","1914","2.48","20","290","2337","18.1","423","5350"
"220",11,1994,"59","12","45","709","4691","1896","2.47","14","36","2342","19","446","5400"
"221",11,1995,"78","19","74","735","4814","1954","2.46","4","145","2354","17","400","5549"
"222",11,1996,"70","52","73","1072","4551","1865","2.44","-3","77","2373","21.4","508","5623"
"223",11,1997,"56","15","70","1479","4161","1730","2.41","-14","31","2425","28.7","695","5640"
"224",11,1998,"72","23","74","1846","4147","1734","2.39","-2","355","2440","28.9","706","5993"
"225",11,1999,"82","14","62","2213","3783","1591","2.38","20","-17","2463","35.4","872","5996"
"226",11,2000,"66","4","65","926","5041","1994","2.53","1","-35","2365","15.7","371","5967"
"227",11,2001,"69","17","64","878","5004","1995","2.51","5","-90","2362","15.5","367","5882"
"228",11,2002,"66","12","78","1067","5136","2063","2.49","-12","333","2353","12.3","290","6203"
"229",11,2003,"62","11","66","1408","5245","2123","2.47","-4","454","2343","9.4","220","6653"
"230",11,2004,"63","0","64","1505","4852","1979","2.45","-1","-295","2323","14.8","344","6357"
"231",11,2005,"63","10","49","1565","4696","1931","2.43","14","-110","2312","16.5","381","6261"
"232",11,2006,"60","9","72","1553","4523","1874","2.41","-12","-173","2300","18.5","426","6076"
"233",11,2007,"68","4","56","1525","4248","1773","2.4","12","-315","2285","22.4","512","5773"
"234",11,2008,"64","7","73","1760","4248","1789","2.37","-9","244","2271","21.2","482","6008"
"235",11,2009,"63","5","69","2216","4265","1810","2.36","-6","479","2255","19.7","445","6481"
"236",11,2010,"54","1","58","2208","4298","1835","2.34","-4","29","2243","18.2","408","6506"
"237",11,2011,"44","5","60","2114","4222","1802","2.34","-16","-154","2248","19.8","446","6336"
"238",11,2012,"55","1","60","1686","4140","1767","2.34","-5","-505","2250","21.5","483","5826"
"239",11,2013,"38","1","62","1715","4029","1720","2.34","-24","-58","2254","23.7","534","5744"
"240",11,2014,"32","2","49","1869","3906","1668","2.34","-17","48","2256","26.1","588","5775"
"241",11,2015,"42","0","55","1907","3963","1692","2.34","-13","108","2256","25","564","5870"
"242",11,2016,"34","4","61","1735","3902","1666","2.34","-27","-206","2260","26.3","594","5637"
"243",11,2017,"42","2","72","1934","3900","1665","2.34","-30","227","2262","26.4","597","5834"
"244",11,2018,"30","3","83","1932","3887","1659","2.34","-53","38","2265","26.8","606","5819"
"245",11,2019,"45","3","64","1934","3864","1649","2.34","-19","-2","2267","27.3","618","5798"
"246",13,1985,"3326","1953","1064","8600","200844","79100","2.54","2262","-3005","88178","10.3","9078","209444"
"247",13,1986,"3272","1944","1007","8729","203112","80731","2.52","2265","132","90087","10.4","9356","211841"
"248",13,1987,"3251","1626","1061","8780","205442","82203","2.5","2190","191","92060","10.7","9857","214222"
"249",13,1988,"3231","925","1071","9384","208996","84226","2.48","2160","1998","93728","10.1","9502","218380"
"250",13,1989,"3230","1056","1065","10854","211500","85911","2.46","2165","1809","94466","9.1","8555","222354"
"251",13,1990,"3320","1375","1094","8640","217374","88402","2.46","2226","1434","94621","6.6","6219","226014"
"252",13,1991,"3323","1478","1104","9097","221880","89867","2.47","2219","2744","96048","6.4","6181","230977"
"253",13,1992,"3332","2734","1043","9266","229131","93100","2.46","2289","5131","97631","4.6","4531","238397"
"254",13,1993,"3228","2684","1191","9561","237714","96796","2.46","2037","6841","100204","3.4","3408","247275"
"255",13,1994,"3166","2191","1205","9469","243256","98566","2.47","1961","3489","102888","4.2","4322","252725"
"256",13,1995,"3050","2938","1281","9606","247894","100377","2.47","1769","3006","105055","4.5","4678","257500"
"257",13,1996,"3199","2588","1242","9561","252204","102053","2.47","1957","2308","107800","5.3","5747","261765"
"258",13,1997,"3182","3062","1352","9328","256735","104480","2.46","1830","2468","110475","5.4","5995","266063"
"259",13,1998,"3377","4687","1343","9514","264601","107096","2.47","2034","6018","113224","5.4","6128","274115"
"260",13,1999,"3513","2780","1369","9700","274224","109720","2.5","2144","7665","117952","7","8232","283924"
"261",13,2000,"3719","621","1388","8506","267749","109578","2.44","2331","-10004","114121","4","4543","276255"
"262",13,2001,"3833","2483","1444","8794","274716","112448","2.44","2389","4866","116588","3.6","4140","283510"
"263",13,2002,"3829","2230","1403","8906","275527","112904","2.44","2426","-1503","118445","4.7","5541","284433"
"264",13,2003,"3636","1775","1474","8883","273880","112395","2.44","2162","-3832","120272","6.6","7877","282763"
"265",13,2004,"3571","1606","1434","8600","274688","112905","2.43","2137","-1612","121715","7.2","8810","283288"
"266",13,2005,"3510","1771","1378","8562","274348","112978","2.43","2132","-2510","123133","8.3","10155","282910"
"267",13,2006,"3511","1427","1471","9931","276202","113945","2.42","2040","1183","124311","8.3","10366","286133"
"268",13,2007,"3390","953","1481","9809","278948","115320","2.42","1909","715","125261","7.9","9941","288757"
"269",13,2008,"3353","701","1524","9935","281892","116788","2.41","1829","1241","125999","7.3","9211","291827"
"270",13,2009,"3187","1044","1512","9879","283762","117841","2.41","1675","139","126756","7","8915","293641"
"271",13,2010,"3141","98","1544","9396","286209","119566","2.39","1597","367","127182","6","7616","295605"
"272",13,2011,"2995","690","1510","9717","290520","121395","2.39","1485","3147","128005","5.2","6610","300237"
"273",13,2012,"2954","785","1571","10034","295282","123361","2.39","1383","3696","128685","4.1","5324","305316"
"274",13,2013,"2963","1388","1666","10319","299734","125196","2.39","1297","3440","130036","3.7","4840","310053"
"275",13,2014,"2939","1677","1709","10603","302484","126380","2.39","1230","1804","131562","3.9","5182","313087"
"276",13,2015,"2857","1460","1784","10977","307956","128593","2.39","1073","4773","132828","3.2","4235","318933"
"277",13,2016,"2841","1439","1813","10905","311296","129911","2.4","1028","2240","134175","3.2","4264","322201"
"278",13,2017,"2628","1857","1790","10966","312401","130330","2.4","838","328","136006","4.2","5676","323367"
"279",13,2018,"2580","1779","1832","11006","314631","131112","2.4","748","1522","137527","4.7","6415","325637"
"280",13,2019,"2525","3240","1998","10966","316198","131665","2.4","527","1000","140891","6.5","9226","327164"
"281",14,1985,"0","0","0","0","0","0","0","0","0","0","0","0","0"
"282",14,1986,"0","0","0","0","0","0","0","0","0","0","0","0","0"
"283",14,1987,"0","0","0","0","0","0","0","0","0","0","0","0","0"
"284",14,1988,"0","0","0","0","0","0","0","0","0","0","0","0","0"
"285",14,1989,"0","0","0","0","0","0","0","0","0","0","0","0","0"
"286",14,1990,"0","0","0","0","0","0","0","0","0","0","0","0","0"
"287",14,1991,"0","0","0","0","0","0","0","0","0","0","0","0","0"
"288",14,1992,"0","0","0","0","0","0","0","0","0","0","0","0","0"
"289",14,1993,"0","0","0","0","0","0","0","0","0","0","0","0","0"
"290",14,1994,"0","0","0","0","0","0","0","0","0","0","0","0","0"
"291",14,1995,"0","0","0","0","0","0","0","0","0","0","0","0","0"
"292",14,1996,"0","0","0","0","0","0","0","0","0","0","0","0","0"
"293",14,1997,"0","0","0","0","0","0","0","0","0","0","0","0","0"
"294",14,1998,"0","0","0","0","0","0","0","0","0","0","0","0","0"
"295",14,1999,"0","0","0","0","0","0","0","0","0","0","0","0","0"
"296",14,2000,"0","112","0","7","38537","13949","2.76","0","38544","14450","3.5","501","38544"
"297",14,2001,"0","446","0","7","41380","15071","2.75","0","2843","15056","-0.1","-15","41387"
"298",14,2002,"421","1070","116","7","42425","15548","2.73","305","740","15881","2.1","333","42432"
"299",14,2003,"689","856","190","7","44953","16578","2.71","499","2029","16800","1.3","222","44960"
"300",14,2004,"604","621","208","7","46399","17219","2.69","396","1050","17548","1.9","329","46406"
"301",14,2005,"649","715","193","7","48244","18018","2.68","456","1389","18778","4.1","760","48251"
"302",14,2006,"676","742","228","7","51145","19223","2.66","448","2453","19729","2.6","506","51152"
"303",14,2007,"722","1027","231","7","53321","20170","2.64","491","1685","20727","2.7","557","53328"
"304",14,2008,"723","1006","230","7","54393","20709","2.63","493","579","21472","3.6","763","54400"
"305",14,2009,"693","794","244","7","55371","21219","2.61","449","529","22327","5","1108","55378"
"306",14,2010,"690","40","271","282","55825","21498","2.6","419","310","22685","5.2","1187","56107"
"307",14,2011,"682","232","316","282","57099","21989","2.6","366","908","22910","4","921","57381"
"308",14,2012,"673","229","318","282","58581","22559","2.6","355","1127","23134","2.5","575","58863"
"309",14,2013,"684","2010","323","282","59771","23018","2.6","361","829","25104","8.3","2086","60053"
"310",14,2014,"699","896","347","282","61388","23640","2.6","352","1265","25981","9","2341","61670"
"311",14,2015,"671","1067","358","282","64498","24838","2.6","313","2797","27021","8.1","2183","64780"
"312",14,2016,"735","709","377","282","66167","25481","2.6","358","1311","27710","8","2229","66449"
"313",14,2017,"673","779","352","282","67900","26148","2.6","321","1412","28477","8.2","2329","68182"
"314",14,2018,"634","416","373","644","68947","26551","2.6","261","1148","28894","8.1","2343","69591"
"315",14,2019,"685","785","435","282","70480","27142","2.6","250","921","29663","8.5","2521","70762"
"316",15,1985,"156","73","107","612","11737","4543","2.58","49","-538","6402","29","1859","12349"
"317",15,1986,"169","39","136","620","11853","4617","2.57","33","91","6473","28.7","1856","12473"
"318",15,1987,"129","49","107","620","11833","4632","2.55","22","-42","6511","28.9","1879","12453"
"319",15,1988,"148","58","120","923","11467","4434","2.59","28","-91","6572","32.5","2138","12390"
"320",15,1989,"132","42","121","1128","11431","4532","2.52","11","158","6575","31.1","2043","12559"
"321",15,1990,"133","36","107","1158","11548","4848","2.38","26","121","6547","26","1699","12706"
"322",15,1991,"125","104","117","1230","11634","5027","2.31","8","150","6583","23.6","1556","12864"
"323",15,1992,"112","83","155","1288","11833","5108","2.32","-43","300","6687","23.6","1579","13121"
"324",15,1993,"128","117","142","1535","12165","5176","2.35","-14","593","6770","23.6","1594","13700"
"325",15,1994,"127","182","157","1314","12793","5438","2.35","-30","437","6887","21","1449","14107"
"326",15,1995,"115","211","121","1248","13408","5719","2.34","-6","555","7069","19.1","1350","14656"
"327",15,1996,"111","253","139","1291","13834","5932","2.33","-28","497","7280","18.5","1348","15125"
"328",15,1997,"132","166","162","1331","14075","6102","2.31","-30","311","7533","19","1431","15406"
"329",15,1998,"143","197","144","1351","14175","6147","2.31","-1","121","7699","20.2","1552","15526"
"330",15,1999,"138","218","126","1371","14565","6350","2.29","12","398","7914","19.8","1564","15936"
"331",15,2000,"137","56","134","1363","14949","6623","2.26","3","374","8449","21.6","1826","16312"
"332",15,2001,"157","224","146","1337","15073","6707","2.25","11","87","8660","22.6","1953","16410"
"333",15,2002,"139","213","162","1333","15313","6844","2.24","-23","259","8840","22.6","1996","16646"
"334",15,2003,"137","241","137","1360","15434","6928","2.23","0","148","9060","23.5","2132","16794"
"335",15,2004,"147","196","147","1332","15614","7041","2.22","0","152","9243","23.8","2202","16946"
"336",15,2005,"151","164","140","1338","15684","7109","2.21","11","65","9419","24.5","2310","17022"
"337",15,2006,"142","151","162","1336","15648","7127","2.2","-20","-18","9549","25.4","2422","16984"
"338",15,2007,"132","154","153","1408","15830","7247","2.18","-21","275","9725","25.5","2478","17238"
"339",15,2008,"130","209","169","1337","16066","7391","2.17","-39","204","9943","25.7","2552","17403"
"340",15,2009,"156","130","143","1366","16238","7507","2.16","13","188","9988","24.8","2481","17604"
"341",15,2010,"138","23","157","1436","16361","7596","2.15","-19","212","10042","24.4","2446","17797"
"342",15,2011,"147","126","157","1492","16539","7676","2.15","-10","244","10150","24.4","2474","18031"
"343",15,2012,"152","87","157","1489","16675","7740","2.15","-5","138","10229","24.3","2489","18164"
"344",15,2013,"110","106","179","1345","16985","7883","2.15","-69","235","10337","23.7","2454","18330"
"345",15,2014,"143","116","168","1491","16971","7877","2.15","-25","157","10446","24.6","2569","18462"
"346",15,2015,"138","154","203","1443","17161","7965","2.15","-65","207","10601","24.9","2636","18604"
"347",15,2016,"134","174","184","1501","17615","8178","2.15","-50","562","10789","24.2","2611","19116"
"348",15,2017,"130","289","177","1488","18173","8438","2.15","-47","592","11075","23.8","2637","19661"
"349",15,2018,"144","269","173","1499","18564","8616","2.15","-29","431","11346","24.1","2730","20063"
"350",15,2019,"127","162","185","1488","18873","8761","2.15","-58","356","11565","24.2","2804","20361"
"351",17,1985,"55","3","21","14","2280","965","2.36","34","23","1060","9","95","2294"
"352",17,1986,"35","2","24","13","2172","937","2.32","11","-120","1090","14","153","2185"
"353",17,1987,"37","1","27","13","2084","919","2.27","10","-98","1119","17.9","200","2097"
"354",17,1988,"48","5","26","14","2194","985","2.23","22","89","1122","12.2","137","2208"
"355",17,1989,"46","2","35","15","2299","1021","2.25","11","95","1128","9.5","107","2314"
"356",17,1990,"26","4","22","45","2368","904","2.62","4","95","1083","16.5","179","2413"
"357",17,1991,"40","2","24","40","2436","818","2.98","16","47","1087","24.8","269","2476"
"358",17,1992,"41","3","22","45","2362","910","2.6","19","-88","1089","16.4","179","2407"
"359",17,1993,"36","5","21","44","2262","886","2.55","15","-116","1092","18.9","206","2306"
"360",17,1994,"20","4","21","44","2247","885","2.54","-1","-14","1097","19.3","212","2291"
"361",17,1995,"29","2","17","44","2225","880","2.53","12","-34","1101","20.1","221","2269"
"362",17,1996,"33","2","21","45","2239","893","2.51","12","3","1103","19","210","2284"
"363",17,1997,"19","6","26","46","2249","910","2.47","-7","18","1105","17.7","195","2295"
"364",17,1998,"30","2","26","46","2297","935","2.46","4","44","1111","15.8","176","2343"
"365",17,1999,"32","3","23","46","2233","916","2.44","9","-73","1113","17.7","197","2279"
"366",17,2000,"23","1","15","30","2186","876","2.5","8","-68","1103","20.6","227","2216"
"367",17,2001,"17","3","15","30","2143","865","2.48","2","-45","1090","20.6","225","2173"
"368",17,2002,"28","4","20","30","2132","869","2.45","8","-19","1078","19.4","209","2162"
"369",17,2003,"21","0","32","30","2089","861","2.43","-11","-32","1064","19.1","203","2119"
"370",17,2004,"17","1","28","30","2040","847","2.41","-11","-38","1050","19.3","203","2070"
"371",17,2005,"22","3","27","30","2011","844","2.38","-5","-24","1038","18.7","194","2041"
"372",17,2006,"21","3","21","30","1947","823","2.37","0","-64","1026","19.8","203","1977"
"373",17,2007,"26","1","14","30","1880","801","2.35","12","-79","1013","20.9","212","1910"
"374",17,2008,"24","0","19","30","1868","804","2.32","5","-17","999","19.5","195","1898"
"375",17,2009,"22","0","34","30","1803","785","2.3","-12","-53","985","20.3","200","1833"
"376",17,2010,"21","0","18","42","1792","786","2.28","3","-2","975","19.4","189","1834"
"377",17,2011,"21","1","21","42","1822","799","2.28","0","30","976","18.1","177","1864"
"378",17,2012,"38","0","27","42","1831","802","2.28","11","-2","976","17.8","174","1873"
"379",17,2013,"27","4","18","42","1838","805","2.28","9","-2","985","18.3","180","1880"
"380",17,2014,"27","1","15","42","1805","791","2.28","12","-45","986","19.8","195","1847"
"381",17,2015,"29","7","19","42","1788","783","2.28","10","-27","993","21.1","210","1830"
"382",17,2016,"26","9","21","42","1812","793","2.28","5","19","1001","20.8","208","1854"
"383",17,2017,"21","3","20","42","1814","794","2.28","1","1","1005","21","211","1856"
"384",17,2018,"15","3","22","42","1815","794","2.29","-7","8","1008","21.2","214","1857"
"385",17,2019,"7","6","9","42","1783","779","2.29","-2","-30","1012","23","233","1825"
"386",19,1985,"140","53","40","45","7891","3093","2.55","100","84","4596","32.7","1503","7936"
"387",19,1986,"123","35","37","46","8113","3184","2.55","86","137","4647","31.5","1463","8159"
"388",19,1987,"131","39","26","44","7778","3055","2.55","105","-442","4681","34.7","1626","7822"
"389",19,1988,"112","18","33","43","7684","3024","2.54","79","-174","4724","36","1700","7727"
"390",19,1989,"115","18","35","42","7625","3006","2.54","80","-140","4839","37.9","1833","7667"
"391",19,1990,"105","23","34","45","7568","3153","2.4","71","-125","4811","34.5","1658","7613"
"392",19,1991,"108","22","32","41","7612","2972","2.56","76","-36","4834","38.5","1862","7653"
"393",19,1992,"114","65","34","44","7798","3132","2.49","80","109","4856","35.5","1724","7842"
"394",19,1993,"114","69","37","47","7990","3324","2.4","77","118","4921","32.5","1597","8037"
"395",19,1994,"118","81","44","50","8408","3485","2.41","74","347","4990","30.2","1505","8458"
"396",19,1995,"117","83","54","50","8634","3579","2.41","63","163","5071","29.4","1492","8684"
"397",19,1996,"122","93","50","50","8666","3606","2.4","72","-40","5154","30","1548","8716"
"398",19,1997,"103","83","36","51","8829","3700","2.39","67","97","5247","29.5","1547","8880"
"399",19,1998,"101","102","36","51","8947","3750","2.39","65","53","5330","29.6","1580","8998"
"400",19,1999,"116","88","42","51","9132","3827","2.39","74","111","5432","29.6","1605","9183"
"401",19,2000,"110","14","39","42","9319","4050","2.3","71","104","5175","21.7","1125","9361"
"402",19,2001,"118","56","38","42","9422","4122","2.29","80","23","5245","21.4","1123","9464"
"403",19,2002,"108","63","50","42","9424","4151","2.27","58","-56","5313","21.9","1162","9466"
"404",19,2003,"92","71","48","42","9475","4200","2.26","44","7","5382","22","1182","9517"
"405",19,2004,"102","56","44","42","9419","4203","2.24","58","-114","5461","23","1258","9461"
"406",19,2005,"99","41","60","42","9350","4203","2.22","39","-108","5511","23.7","1308","9392"
"407",19,2006,"121","34","42","42","9237","4179","2.21","79","-192","5545","24.6","1366","9279"
"408",19,2007,"82","33","57","42","9291","4233","2.19","25","29","5596","24.4","1363","9333"
"409",19,2008,"99","22","43","42","9252","4243","2.18","56","-95","5638","24.7","1395","9294"
"410",19,2009,"76","15","43","42","9018","4165","2.17","33","-267","5664","26.5","1499","9060"
"411",19,2010,"81","2","64","131","9024","4217","2.14","17","78","5687","25.8","1470","9155"
"412",19,2011,"69","13","58","104","8950","4183","2.14","11","-112","5700","26.6","1517","9054"
"413",19,2012,"63","16","46","121","8948","4181","2.14","17","-2","5716","26.9","1535","9069"
"414",19,2013,"70","6","59","90","8955","4184","2.14","11","-35","5711","26.7","1527","9045"
"415",19,2014,"80","45","62","85","9055","4230","2.14","18","77","5750","26.4","1520","9140"
"416",19,2015,"62","12","60","111","9178","4288","2.14","2","147","5759","25.5","1471","9289"
"417",19,2016,"74","20","60","113","9279","4334","2.14","14","89","5775","25","1441","9392"
"418",19,2017,"76","12","53","115","9499","4437","2.14","23","199","5787","23.3","1350","9614"
"419",19,2018,"80","30","69","125","9527","4451","2.14","11","27","5817","23.5","1366","9652"
"420",19,2019,"77","34","71","115","9625","4498","2.14","6","82","5849","23.1","1351","9740"
"421",21,1985,"143","1","60","0","7776","2486","3.13","83","-312","3316","25","830","7776"
"422",21,1986,"137","0","79","0","7947","2576","3.09","58","113","3313","22.3","737","7947"
"423",21,1987,"137","4","71","0","8090","2649","3.05","66","77","3310","20","661","8090"
"424",21,1988,"133","1","49","0","7854","2599","3.02","84","-320","3318","21.7","719","7854"
"425",21,1989,"137","0","63","0","7623","2553","2.99","74","-305","3309","22.9","756","7623"
"426",21,1990,"128","1","54","30","7421","2492","2.98","74","-246","3574","30.3","1082","7451"
"427",21,1991,"111","0","54","28","7506","2378","3.16","57","26","3575","33.5","1197","7534"
"428",21,1992,"113","1","82","29","7485","2443","3.06","31","-51","3575","31.7","1132","7514"
"429",21,1993,"127","0","63","30","7612","2518","3.02","64","64","3576","29.6","1058","7642"
"430",21,1994,"116","4","71","31","7724","2543","3.04","45","68","3581","29","1038","7755"
"431",21,1995,"116","1","76","31","7875","2582","3.05","40","111","3585","28","1003","7906"
"432",21,1996,"132","168","70","31","7988","2615","3.05","62","51","3586","27.1","971","8019"
"433",21,1997,"128","166","66","32","8068","2651","3.04","62","19","3754","29.4","1103","8100"
"434",21,1998,"134","175","84","32","8155","2670","3.05","50","37","3920","31.9","1250","8187"
"435",21,1999,"121","181","72","32","8276","2698","3.07","49","72","3888","30.6","1190","8308"
"436",21,2000,"142","0","85","53","8355","2989","2.8","57","38","3887","23.1","898","8408"
"437",21,2001,"133","0","72","53","8312","2990","2.78","61","-104","3886","23.1","896","8365"
"438",21,2002,"105","0","74","53","8336","3015","2.76","31","-7","3887","22.4","872","8389"
"439",21,2003,"109","198","75","53","8334","3032","2.75","34","-36","4084","25.8","1052","8387"
"440",21,2004,"122","29","75","53","8448","3093","2.73","47","67","4112","24.8","1019","8501"
"441",21,2005,"123","46","72","53","8447","3111","2.72","51","-52","4157","25.2","1046","8500"
"442",21,2006,"116","36","64","53","8417","3120","2.7","52","-82","4193","25.6","1073","8470"
"443",21,2007,"127","37","74","53","8380","3123","2.68","53","-90","4228","26.1","1105","8433"
"444",21,2008,"123","28","77","53","8331","3123","2.67","46","-95","4257","26.6","1134","8384"
"445",21,2009,"113","14","79","53","8157","3079","2.65","34","-208","4274","28","1195","8210"
"446",21,2010,"137","4","73","36","8246","3128","2.64","64","8","4289","27.1","1161","8282"
"447",21,2011,"104","17","88","36","8223","3118","2.64","16","-39","4307","27.6","1189","8259"
"448",21,2012,"126","13","82","36","8184","3104","2.64","44","-83","4321","28.2","1217","8220"
"449",21,2013,"109","13","99","36","8139","3087","2.64","10","-55","4335","28.8","1248","8175"
"450",21,2014,"122","15","71","36","8167","3097","2.64","51","-23","4350","28.8","1253","8203"
"451",21,2015,"116","13","93","36","8003","3035","2.64","23","-187","4364","30.5","1329","8039"
"452",21,2016,"96","21","88","36","7986","3028","2.64","8","-25","4385","30.9","1357","8022"
"453",21,2017,"95","20","71","36","8084","3064","2.64","24","74","4405","30.4","1341","8120"
"454",21,2018,"82","24","92","36","8103","3072","2.64","-10","29","4429","30.6","1357","8139"
"455",21,2019,"103","22","92","36","8125","3081","2.64","11","11","4457","30.9","1376","8161"
"456",23,1985,"50","0","20","0","3363","1167","2.88","30","73","1614","27.7","447","3363"
"457",23,1986,"39","0","36","0","3307","1158","2.86","3","-59","1640","29.4","482","3307"
"458",23,1987,"57","0","24","0","3349","1181","2.84","33","9","1667","29.2","486","3349"
"459",23,1988,"43","0","23","0","3397","1207","2.81","20","28","1671","27.8","464","3397"
"460",23,1989,"54","0","21","0","3277","1175","2.79","33","-153","1600","26.6","425","3277"
"461",23,1990,"40","0","29","2","3191","1192","2.68","11","-95","1743","31.6","551","3193"
"462",23,1991,"40","0","23","0","3256","1137","2.86","17","46","1743","34.8","606","3256"
"463",23,1992,"45","0","24","2","3188","1196","2.67","21","-87","1743","31.4","547","3190"
"464",23,1993,"44","0","38","2","3335","1223","2.73","6","141","2133","42.7","910","3337"
"465",23,1994,"50","0","33","2","3374","1224","2.76","17","22","2133","42.6","909","3376"
"466",23,1995,"58","0","36","2","3509","1265","2.77","22","113","2133","40.7","868","3511"
"467",23,1996,"42","0","39","2","3579","1290","2.77","3","67","2133","39.5","843","3581"
"468",23,1997,"47","0","46","2","3639","1314","2.77","1","59","2133","38.4","819","3641"
"469",23,1998,"40","0","37","2","3698","1329","2.78","3","56","2133","37.7","804","3700"
"470",23,1999,"50","0","36","2","3677","1314","2.8","14","-35","2133","38.4","819","3679"
"471",23,2000,"40","0","37","0","3674","1511","2.43","3","-9","2211","31.7","700","3674"
"472",23,2001,"47","0","38","0","3741","1547","2.42","9","58","2244","31.1","697","3741"
"473",23,2002,"47","0","33","0","3734","1557","2.4","14","-21","2278","31.7","721","3734"
"474",23,2003,"48","0","46","0","3800","1594","2.38","2","64","2300","30.7","706","3800"
"475",23,2004,"29","0","51","0","3802","1605","2.37","-22","24","2330","31.1","725","3802"
"476",23,2005,"39","25","34","0","3695","1570","2.35","5","-112","2373","33.8","803","3695"
"477",23,2006,"39","23","39","0","3698","1583","2.34","0","3","2426","34.8","843","3698"
"478",23,2007,"29","19","32","0","3676","1585","2.32","-3","-19","2473","35.9","888","3676"
"479",23,2008,"31","17","38","0","3611","1569","2.3","-7","-58","2523","37.8","954","3611"
"480",23,2009,"33","12","29","0","3505","1533","2.29","4","-110","2584","40.7","1051","3505"
"481",23,2010,"27","8","28","0","3532","1554","2.27","-1","28","2651","41.4","1097","3532"
"482",23,2011,"37","54","32","0","3648","1606","2.27","5","111","2711","40.8","1105","3648"
"483",23,2012,"29","22","41","0","3608","1587","2.27","-12","-28","2715","41.5","1128","3608"
"484",23,2013,"29","23","43","0","3549","1562","2.27","-14","-45","2720","42.6","1158","3549"
"485",23,2014,"28","27","42","0","3573","1572","2.27","-14","38","2720","42.2","1148","3573"
"486",23,2015,"29","30","34","0","3587","1578","2.27","-5","19","2720","42","1142","3587"
"487",23,2016,"30","35","47","0","3706","1630","2.27","-17","136","2720","40.1","1090","3706"
"488",23,2017,"40","44","36","0","3772","1659","2.27","4","62","2721","39","1062","3772"
"489",23,2018,"31","0","43","0","3816","1678","2.27","-12","56","2723","38.4","1045","3816"
"490",23,2019,"27","0","44","0","3872","1704","2.27","-17","73","2784","38.8","1080","3872"
"491",25,1985,"51","1","36","53","2944","1262","2.33","15","94","1309","3.6","47","2997"
"492",25,1986,"51","3","42","53","2932","1288","2.28","9","-21","1310","1.7","22","2985"
"493",25,1987,"42","42","33","56","3016","1341","2.25","9","78","1362","1.5","21","3072"
"494",25,1988,"41","1","31","945","2897","1340","2.16","10","760","1405","4.6","65","3842"
"495",25,1989,"32","1","48","1070","2831","1322","2.14","-16","75","1405","5.9","83","3901"
"496",25,1990,"49","1","27","1031","2898","1165","2.49","22","6","1415","17.7","250","3929"
"497",25,1991,"50","1","26","1052","2921","1175","2.49","24","20","1416","17","241","3973"
"498",25,1992,"46","0","38","1089","3051","1224","2.49","8","159","1417","13.6","193","4140"
"499",25,1993,"40","0","46","1081","3064","1223","2.51","-6","11","1417","13.7","194","4145"
"500",25,1994,"29","1","56","1135","3072","1240","2.48","-27","89","1417","12.5","177","4207"
"501",25,1995,"51","1","37","1078","3143","1289","2.44","14","0","1418","9.1","129","4221"
"502",25,1996,"48","2","49","1140","3126","1324","2.36","-1","46","1419","6.7","95","4266"
"503",25,1997,"44","2","37","1184","3119","1338","2.33","7","30","1442","7.2","104","4303"
"504",25,1998,"52","2","51","1177","3109","1350","2.3","1","-18","1444","6.5","94","4286"
"505",25,1999,"48","4","38","1920","3078","1467","2.1","10","702","1539","4.7","72","4998"
"506",25,2000,"45","5","34","1590","3540","1369","2.59","11","117","1546","11.5","177","5130"
"507",25,2001,"41","19","39","1842","3411","1327","2.57","2","121","1561","15","234","5253"
"508",25,2002,"42","3","49","1975","3369","1319","2.55","-7","98","1561","15.5","242","5344"
"509",25,2003,"43","2","49","1850","3306","1305","2.53","-6","-182","1560","16.4","255","5156"
"510",25,2004,"53","1","55","2125","3307","1316","2.51","-2","278","1558","15.5","242","5432"
"511",25,2005,"40","4","48","2240","3197","1281","2.5","-8","13","1560","17.9","279","5437"
"512",25,2006,"35","5","47","2580","3133","1264","2.48","-12","288","1561","19","297","5713"
"513",25,2007,"28","0","45","2865","3042","1238","2.46","-17","211","1559","20.6","321","5907"
"514",25,2008,"31","8","40","2925","2968","1217","2.44","-9","-5","1562","22.1","345","5893"
"515",25,2009,"44","0","47","2938","2865","1184","2.42","-3","-87","1561","24.2","377","5803"
"516",25,2010,"37","0","32","2682","3156","1311","2.41","5","30","1559","15.9","248","5838"
"517",25,2011,"34","4","36","2638","3211","1335","2.41","-2","13","1563","14.6","228","5849"
"518",25,2012,"40","2","47","2291","3138","1306","2.4","-7","-413","1565","16.5","259","5429"
"519",25,2013,"41","0","39","2242","3069","1276","2.41","2","-120","1565","18.5","289","5311"
"520",25,2014,"31","3","42","2516","3064","1273","2.41","-11","280","1568","18.8","295","5580"
"521",25,2015,"42","7","37","2580","3017","1254","2.41","5","12","1575","20.4","321","5597"
"522",25,2016,"27","5","56","2208","3044","1265","2.41","-29","-316","1580","19.9","315","5252"
"523",25,2017,"29","4","48","2823","3002","1248","2.41","-19","592","1584","21.2","336","5825"
"524",25,2018,"29","3","37","2827","3112","1293","2.41","-8","122","1587","18.5","294","5939"
"525",25,2019,"28","1","45","2823","3209","1333","2.41","-17","110","1588","16.1","255","6032"
"526",27,1985,"22","0","22","18","2048","823","2.49","0","160","1300","36.7","477","2066"
"527",27,1986,"26","1","18","18","2057","839","2.45","8","1","1304","35.7","465","2075"
"528",27,1987,"25","1","6","18","2032","839","2.42","19","-44","1310","36","471","2050"
"529",27,1988,"17","14","12","17","1959","821","2.39","5","-79","1313","37.5","492","1976"
"530",27,1989,"24","0","15","17","1930","821","2.35","9","-38","1336","38.6","515","1947"
"531",27,1990,"13","0","6","1","1943","770","2.52","7","-10","2216","65.3","1446","1944"
"532",27,1991,"13","37","12","1","2011","832","2.42","1","67","2216","62.5","1384","2012"
"533",27,1992,"28","44","19","1","2140","941","2.27","9","120","2253","58.2","1312","2141"
"534",27,1993,"19","66","22","1","2322","945","2.46","-3","185","2297","58.9","1352","2323"
"535",27,1994,"36","87","14","1","2417","986","2.45","22","73","2363","58.3","1377","2418"
"536",27,1995,"34","92","12","1","2617","1075","2.43","22","178","2450","56.1","1375","2618"
"537",27,1996,"35","81","24","1","2847","1182","2.41","11","219","2542","53.5","1360","2848"
"538",27,1997,"30","218","13","1","3056","1286","2.38","17","192","2623","51","1337","3057"
"539",27,1998,"35","137","14","1","3174","1343","2.36","21","97","2841","52.7","1498","3175"
"540",27,1999,"34","90","21","1","3363","1434","2.35","13","176","2978","51.9","1544","3364"
"541",27,2000,"35","35","21","16","3504","1491","2.35","14","149","3029","50.8","1538","3520"
"542",27,2001,"30","139","15","16","3714","1595","2.33","15","195","3079","48.2","1484","3730"
"543",27,2002,"31","115","27","16","3767","1633","2.31","4","49","3157","48.3","1524","3783"
"544",27,2003,"25","162","28","16","3918","1715","2.28","-3","154","3249","47.2","1534","3934"
"545",27,2004,"36","126","21","16","3968","1755","2.26","15","35","3313","47","1558","3984"
"546",27,2005,"24","106","30","16","4029","1800","2.24","-6","67","3442","47.7","1642","4045"
"547",27,2006,"15","100","33","16","4001","1806","2.22","-18","-10","3573","49.5","1767","4017"
"548",27,2007,"23","85","26","16","4114","1873","2.2","-3","116","3696","49.3","1823","4130"
"549",27,2008,"26","69","26","16","4103","1888","2.17","0","-11","3797","50.3","1909","4119"
"550",27,2009,"24","51","39","16","4150","1931","2.15","-15","62","3888","50.3","1957","4166"
"551",27,2010,"25","15","37","15","4257","1997","2.13","-12","118","3973","49.7","1976","4272"
"552",27,2011,"22","67","29","15","4204","1972","2.13","-7","-46","4036","51.1","2064","4219"
"553",27,2012,"26","66","36","15","4198","1968","2.13","-10","4","4102","52","2134","4213"
"554",27,2013,"21","54","36","15","4241","1988","2.13","-15","58","4155","52.2","2167","4256"
"555",27,2014,"22","47","34","15","4321","2025","2.13","-12","92","4201","51.8","2176","4336"
"556",27,2015,"26","43","35","15","4415","2069","2.13","-9","103","4243","51.2","2174","4430"
"557",27,2016,"18","43","53","15","4562","2139","2.13","-35","182","4285","50.1","2146","4577"
"558",27,2017,"37","57","44","15","4839","2267","2.13","-7","284","4344","47.8","2077","4854"
"559",27,2018,"32","74","48","15","4909","2300","2.13","-16","86","4416","47.9","2116","4924"
"560",27,2019,"22","77","28","15","5044","2364","2.13","-6","141","4489","47.3","2125","5059"
"561",29,1985,"323","10","245","331","23135","9237","2.5","78","-617","9974","7.4","737","23466"
"562",29,1986,"290","-6","222","316","22037","8903","2.48","68","-1181","9689","8.1","786","22353"
"563",29,1987,"259","3","266","309","21473","8770","2.45","-7","-564","9387","6.6","617","21782"
"564",29,1988,"236","-3","248","351","21151","8735","2.42","-12","-268","9402","7.1","667","21502"
"565",29,1989,"241","-1","265","366","20839","8718","2.39","-24","-273","9397","7.2","679","21205"
"566",29,1990,"227","3","271","500","20491","8372","2.45","-44","-170","10082","17","1710","20991"
"567",29,1991,"236","4","264","652","20577","8635","2.38","-28","266","10085","14.4","1450","21229"
"568",29,1992,"280","40","270","688","21181","9070","2.34","10","630","10089","10.1","1019","21869"
"569",29,1993,"268","39","257","555","22678","9248","2.45","11","1353","10159","9","911","23233"
"570",29,1994,"274","54","284","716","23627","9580","2.47","-10","1120","10453","8.4","873","24343"
"571",29,1995,"306","47","292","719","24474","9902","2.47","14","836","10507","5.8","605","25193"
"572",29,1996,"300","59","319","877","24841","10050","2.47","-19","544","10557","4.8","507","25718"
"573",29,1997,"298","39","311","1121","24884","10143","2.45","-13","300","10616","4.5","473","26005"
"574",29,1998,"309","75","296","1208","25613","10296","2.49","13","803","10655","3.4","359","26821"
"575",29,1999,"299","94","317","1295","26105","10413","2.51","-18","597","10730","3","317","27400"
"576",29,2000,"296","23","330","916","26993","11098","2.43","-34","535","12410","10.6","1312","27909"
"577",29,2001,"316","91","314","929","27458","11312","2.43","2","476","12685","10.8","1373","28387"
"578",29,2002,"317","27","339","923","27855","11500","2.42","-22","413","12926","11","1426","28778"
"579",29,2003,"344","41","329","890","28171","11657","2.42","15","268","13175","11.5","1518","29061"
"580",29,2004,"330","73","299","923","28530","11833","2.41","31","361","13453","12","1620","29453"
"581",29,2005,"336","92","336","934","28478","11838","2.41","0","-41","13733","13.8","1895","29412"
"582",29,2006,"346","113","303","935","28767","11984","2.4","43","247","14040","14.6","2056","29702"
"583",29,2007,"353","143","323","909","28968","12095","2.4","30","145","14265","15.2","2170","29877"
"584",29,2008,"369","110","351","914","29428","12310","2.39","18","447","14439","14.7","2129","30342"
"585",29,2009,"329","91","358","935","29690","12451","2.38","-29","312","14516","14.2","2065","30625"
"586",29,2010,"341","3","339","713","30176","12679","2.38","2","262","14575","13","1896","30889"
"587",29,2011,"344","14","356","680","29731","12490","2.38","-12","-466","14586","14.4","2096","30411"
"588",29,2012,"337","57","316","723","29786","12512","2.38","21","77","14634","14.5","2122","30509"
"589",29,2013,"320","18","317","545","29817","12525","2.38","3","-150","14643","14.5","2118","30362"
"590",29,2014,"292","17","362","683","29300","12307","2.38","-70","-309","14659","16","2352","29983"
"591",29,2015,"271","64","379","692","29243","12282","2.38","-108","60","14718","16.6","2436","29935"
"592",29,2016,"281","7","358","708","29664","12461","2.38","-77","514","14712","15.3","2251","30372"
"593",29,2017,"281","15","382","733","29845","12537","2.38","-101","307","14723","14.8","2186","30578"
"594",29,2018,"280","46","438","723","30196","12686","2.38","-158","499","14766","14.1","2080","30919"
"595",29,2019,"269","48","407","733","30440","12790","2.38","-138","392","14808","13.6","2018","31173"
"596",31,1985,"8952","1272","4541","13031","483400","226540","2.13","4411","-4595","238346","5","11806","496431"
"597",31,1986,"9183","2417","4624","13117","483897","230128","2.1","4559","-3976","239660","4","9532","497014"
"598",31,1987,"8856","1109","4509","13044","477230","229863","2.08","4347","-11087","242120","5.1","12257","490274"
"599",31,1988,"8375","434","4458","13081","466541","227410","2.05","3917","-14569","243234","6.5","15824","479622"
"600",31,1989,"8252","512","4415","12812","459973","227897","2.02","3837","-10674","243525","6.4","15628","472785"
"601",31,1990,"8633","-58","4389","10850","457004","210952","2.17","4244","-9175","239636","12","28684","467854"
"602",31,1991,"8548","-104","4450","11489","463694","216613","2.14","4098","3231","239578","9.6","22965","475183"
"603",31,1992,"8807","283","4565","11751","476507","222322","2.14","4242","8833","239474","7.2","17152","488258"
"604",31,1993,"8611","785","4670","12158","489177","221386","2.21","3941","9136","239757","7.7","18371","501335"
"605",31,1994,"8401","1661","4711","11631","492618","221418","2.22","3690","-776","240542","8","19124","504249"
"606",31,1995,"8062","786","4886","11792","495931","222532","2.23","3176","298","242644","8.3","20112","507723"
"607",31,1996,"8349","1432","4731","11005","507250","225615","2.25","3618","6914","243430","7.3","17815","518255"
"608",31,1997,"8594","2261","4684","10214","517228","229556","2.25","3910","5277","244862","6.3","15306","527442"
"609",31,1998,"8608","4689","4648","10096","523310","231418","2.26","3960","2004","247123","6.4","15705","533406"
"610",31,1999,"9183","3379","4483","13382","532135","240788","2.21","4700","7411","252354","4.6","11566","545517"
"611",31,2000,"9544","887","4390","12719","544019","240360","2.26","5154","6069","252392","4.8","12032","556738"
"612",31,2001,"10297","3546","4310","12922","550378","243645","2.26","5987","575","256223","4.9","12578","563300"
"613",31,2002,"10278","4338","4444","12986","546104","242226","2.25","5834","-10044","260857","7.1","18631","559090"
"614",31,2003,"10404","4491","4234","13123","547225","243200","2.25","6170","-4912","265654","8.5","22454","560348"
"615",31,2004,"10269","2958","4318","13353","546877","243523","2.25","5951","-6069","268921","9.4","25398","560230"
"616",31,2005,"10436","3993","4278","13355","546104","243658","2.24","6158","-6929","273126","10.8","29468","559459"
"617",31,2006,"10134","3047","4194","13367","549495","245655","2.24","5940","-2537","276569","11.2","30914","562862"
"618",31,2007,"10084","3655","4134","13245","557192","249588","2.23","5950","1625","280158","10.9","30570","570437"
"619",31,2008,"10169","3494","4183","13223","568680","255239","2.23","5986","5480","281076","9.2","25837","581903"
"620",31,2009,"10184","3053","4134","13308","582265","261855","2.22","6050","7620","283636","7.7","21781","595573"
"621",31,2010,"9716","222","4229","15981","588898","265233","2.22","5487","3819","287392","7.7","22159","604879"
"622",31,2011,"9634","1263","4184","16220","605865","272875","2.22","5450","11756","288510","5.4","15635","622085"
"623",31,2012,"9189","2236","4170","16214","620421","279431","2.22","5019","9531","290586","3.8","11155","636635"
"624",31,2013,"9261","5382","4216","16123","634753","285886","2.22","5045","9196","295486","3.2","9600","650876"
"625",31,2014,"9327","6219","4233","16218","649853","292687","2.22","5094","10101","301377","2.9","8690","666071"
"626",31,2015,"9365","6117","4323","16517","668309","300999","2.22","5042","13713","307087","2","6088","684826"
"627",31,2016,"9417","8714","4467","16474","681270","306837","2.22","4950","7968","315101","2.6","8264","697744"
"628",31,2017,"9009","7660","4370","16621","689994","310766","2.22","4639","4232","321916","3.5","11150","706615"
"629",31,2018,"8943","11065","4434","16614","701570","315979","2.22","4509","7060","332280","4.9","16301","718184"
"630",31,2019,"8726","7878","4526","16621","712618","320955","2.22","4200","6855","339637","5.5","18682","729239"
"631",33,1985,"27","0","9","0","1548","571","2.71","18","-154","916","37.7","345","1548"
"632",33,1986,"20","0","11","0","1529","571","2.68","9","-28","945","39.6","374","1529"
"633",33,1987,"29","0","13","0","1494","562","2.66","16","-51","974","42.3","412","1494"
"634",33,1988,"24","0","11","0","1591","604","2.63","13","84","976","38.1","372","1591"
"635",33,1989,"18","0","17","0","1541","591","2.61","1","-51","1009","41.4","418","1541"
"636",33,1990,"17","0","10","0","1489","581","2.56","7","-59","947","38.7","366","1489"
"637",33,1991,"16","6","13","0","1437","537","2.68","3","-55","947","43.3","410","1437"
"638",33,1992,"18","4","13","0","1403","502","2.79","5","-39","953","47.3","451","1403"
"639",33,1993,"16","8","13","0","1426","559","2.55","3","20","957","41.6","398","1426"
"640",33,1994,"13","5","8","0","1499","588","2.55","5","68","970","39.4","382","1499"
"641",33,1995,"18","12","21","0","1566","617","2.54","-3","70","975","36.7","358","1566"
"642",33,1996,"23","6","14","0","1636","649","2.52","9","61","987","34.3","338","1636"
"643",33,1997,"24","3","16","0","1674","673","2.49","8","30","993","32.2","320","1674"
"644",33,1998,"13","6","9","0","1766","713","2.48","4","88","996","28.4","283","1766"
"645",33,1999,"16","6","22","0","1811","735","2.46","-6","51","1002","26.7","267","1811"
"646",33,2000,"21","2","18","0","1849","788","2.35","3","36","1200","34.3","412","1849"
"647",33,2001,"22","7","19","0","1865","796","2.34","3","13","1226","35.1","430","1865"
"648",33,2002,"22","8","21","0","1880","805","2.34","1","14","1254","35.8","449","1880"
"649",33,2003,"20","9","24","0","1879","807","2.33","-4","3","1283","37.1","476","1879"
"650",33,2004,"23","7","19","0","1873","805","2.33","4","-10","1312","38.6","507","1873"
"651",33,2005,"21","6","11","0","1888","814","2.32","10","5","1338","39.2","524","1888"
"652",33,2006,"22","6","20","0","1990","860","2.31","2","100","1367","37.1","507","1990"
"653",33,2007,"27","5","20","0","2001","867","2.31","7","4","1394","37.8","527","2001"
"654",33,2008,"30","3","19","0","2074","900","2.3","11","62","1422","36.7","522","2074"
"655",33,2009,"28","1","16","0","2052","892","2.3","12","-34","1448","38.4","556","2052"
"656",33,2010,"17","0","14","0","2060","898","2.29","3","5","1468","38.8","570","2060"
"657",33,2011,"18","37","17","0","2036","887","2.3","1","-25","1504","41","617","2036"
"658",33,2012,"24","61","17","0","2002","872","2.3","7","-41","1564","44.2","692","2002"
"659",33,2013,"17","31","18","0","2026","883","2.29","-1","25","1594","44.6","711","2026"
"660",33,2014,"15","27","30","0","1968","857","2.3","-15","-43","1620","47.1","763","1968"
"661",33,2015,"19","32","12","0","1974","859","2.3","7","-1","1651","48","792","1974"
"662",33,2016,"15","25","14","0","2050","893","2.3","1","75","1675","46.7","782","2050"
"663",33,2017,"12","20","21","0","2039","888","2.3","-9","-2","1695","47.6","807","2039"
"664",33,2018,"16","31","21","0","2054","894","2.3","-5","20","1725","48.2","831","2054"
"665",33,2019,"7","1","18","0","2037","888","2.29","-11","-6","1726","48.6","838","2037"
"666",35,1985,"679","2160","129","163","39885","11824","3.37","550","3214","15225","22.3","3401","40048"
"667",35,1986,"772","2370","122","169","45485","13530","3.36","650","4956","17810","24","4280","45654"
"668",35,1987,"853","1825","133","178","48666","14345","3.39","720","2470","20189","29","5844","48844"
"669",35,1988,"991","1604","171","191","52936","15439","3.43","820","3463","22017","29.9","6578","53127"
"670",35,1989,"1129","1475","162","201","56963","16649","3.42","967","3070","23622","29.5","6973","57164"
"671",35,1990,"1208","1587","144","217","61342","20844","2.94","1064","3331","22291","6.5","1447","61559"
"672",35,1991,"1311","1916","159","239","66449","23010","2.89","1152","3977","23878","3.6","868","66688"
"673",35,1992,"1369","2946","190","271","75090","25714","2.92","1179","7494","25794","0.3","80","75361"
"674",35,1993,"1483","3295","222","295","82837","28231","2.93","1261","6510","28810","2","579","83132"
"675",35,1994,"1617","4045","262","332","92194","31588","2.92","1355","8039","32229","2","641","92526"
"676",35,1995,"1719","4785","239","364","103475","35498","2.91","1480","9833","36274","2.1","776","103839"
"677",35,1996,"1981","5732","251","395","114318","39371","2.9","1730","9144","41059","4.1","1688","114713"
"678",35,1997,"2281","5564","329","442","128889","44778","2.88","1952","12666","46739","4.2","1961","129331"
"679",35,1998,"2525","6443","350","442","143912","49767","2.89","2175","12848","52303","4.9","2536","144354"
"680",35,1999,"2897","7166","399","442","161881","55522","2.92","2498","15471","58385","4.9","2863","162323"
"681",35,2000,"3281","1557","438","654","179856","62610","2.87","2843","15343","65623","4.6","3013","180510"
"682",35,2001,"3648","6227","490","654","198384","69278","2.86","3158","15370","72898","5","3620","199038"
"683",35,2002,"3765","5914","505","654","209051","73226","2.85","3260","7407","79062","7.4","5836","209705"
"684",35,2003,"3999","4397","534","661","220485","77472","2.85","3465","7976","84225","8","6753","221146"
"685",35,2004,"3967","3616","585","581","233065","82144","2.84","3382","9118","88496","7.2","6352","233646"
"686",35,2005,"4159","4987","589","703","243739","86168","2.83","3570","7226","93034","7.4","6866","244442"
"687",35,2006,"4112","5378","654","720","257113","91172","2.82","3458","9933","98058","7","6886","257833"
"688",35,2007,"4205","3786","748","728","267871","95275","2.81","3457","7309","101912","6.5","6637","268599"
"689",35,2008,"3938","2168","784","967","275773","98378","2.8","3154","4987","104350","5.7","5972","276740"
"690",35,2009,"3773","1344","779","1042","281121","100581","2.79","2994","2429","106155","5.3","5574","282163"
"691",35,2010,"3627","213","904","800","286324","102595","2.79","2723","2238","107064","4.2","4469","287124"
"692",35,2011,"3557","1539","905","772","291911","104598","2.79","2652","2907","108488","3.6","3890","292683"
"693",35,2012,"3477","1319","1034","775","298079","106812","2.79","2443","3728","109770","2.7","2958","298854"
"694",35,2013,"3429","2483","1043","871","305619","109547","2.79","2386","5250","112213","2.4","2666","306490"
"695",35,2014,"3536","2590","1035","871","313947","112522","2.79","2501","5827","114733","1.9","2211","314818"
"696",35,2015,"3376","3245","1252","871","321448","115212","2.79","2124","5377","118076","2.4","2864","322319"
"697",35,2016,"3495","3203","1338","871","327677","117417","2.79","2157","4072","120006","2.2","2589","328548"
"698",35,2017,"3507","3601","1337","871","335278","120127","2.79","2170","5431","123455","2.7","3328","336149"
"699",35,2018,"3417","3968","1434","871","342455","122678","2.79","1983","5194","128786","4.7","6108","343326"
"700",35,2019,"3449","4066","1507","871","350657","125570","2.79","1942","6260","132895","5.5","7325","351528"
"701",37,1985,"386","74","41","6","18023","7498","2.4","345","923","13585","44.8","6087","18029"
"702",37,1986,"361","203","56","7","18846","7820","2.41","305","519","13921","43.8","6101","18853"
"703",37,1987,"370","205","61","7","18995","8050","2.36","309","-160","14093","42.9","6043","19002"
"704",37,1988,"370","392","53","7","19560","8396","2.33","317","248","14317","41.4","5921","19567"
"705",37,1989,"415","509","40","7","20874","8971","2.33","375","939","14688","38.9","5717","20881"
"706",37,1990,"421","619","43","116","22002","8354","2.63","378","859","15226","45.1","6872","22118"
"707",37,1991,"411","466","44","118","23340","8763","2.66","367","973","15845","44.7","7082","23458"
"708",37,1992,"431","556","44","125","24815","9157","2.71","387","1095","16524","44.6","7367","24940"
"709",37,1993,"432","910","62","128","26704","9764","2.73","370","1522","17077","42.8","7313","26832"
"710",37,1994,"469","1067","67","145","28882","10754","2.69","402","1793","17987","40.2","7233","29027"
"711",37,1995,"436","1019","62","145","30738","11291","2.72","374","1482","19054","40.7","7763","30883"
"712",37,1996,"492","972","75","150","32778","11906","2.75","417","1628","20073","40.7","8167","32928"
"713",37,1997,"599","1477","62","156","35050","12652","2.77","537","1741","21044","39.9","8392","35206"
"714",37,1998,"630","1125","60","156","37458","13334","2.81","570","1838","22521","40.8","9187","37614"
"715",37,1999,"645","864","49","156","39753","13590","2.93","596","1699","23646","42.5","10056","39909"
"716",37,2000,"774","165","80","353","42936","15751","2.73","694","2685","25145","37.4","9394","43289"
"717",37,2001,"785","661","64","353","44087","16146","2.73","721","430","25966","37.8","9820","44440"
"718",37,2002,"769","533","87","353","44747","16378","2.73","682","-22","26510","38.2","10132","45100"
"719",37,2003,"830","659","88","353","45405","16600","2.74","742","-84","27274","39.1","10674","45758"
"720",37,2004,"794","489","90","353","46132","16849","2.74","704","23","27864","39.5","11015","46485"
"721",37,2005,"769","727","89","353","46925","17124","2.74","680","113","28711","40.4","11587","47278"
"722",37,2006,"851","745","98","353","47861","17448","2.74","753","183","29573","41","12125","48214"
"723",37,2007,"872","578","84","353","48931","17818","2.75","788","282","30271","41.1","12453","49284"
"724",37,2008,"858","520","104","353","49948","18181","2.75","754","263","30917","41.2","12736","50301"
"725",37,2009,"871","164","93","366","51154","18612","2.75","778","441","31165","40.3","12553","51520"
"726",37,2010,"775","19","96","55","52002","19185","2.71","679","-142","31329","38.8","12144","52057"
"727",37,2011,"650","61","83","70","51953","19161","2.71","567","-601","31394","39","12233","52023"
"728",37,2012,"695","53","100","70","52233","19267","2.71","595","-315","31443","38.7","12176","52303"
"729",37,2013,"602","91","120","70","52717","19439","2.71","482","2","31525","38.3","12086","52787"
"730",37,2014,"659","106","121","70","53180","19603","2.71","538","-75","31628","38","12025","53250"
"731",37,2015,"642","244","111","70","53767","19824","2.71","531","56","31872","37.8","12048","53837"
"732",37,2016,"664","183","121","70","54459","20093","2.71","543","149","32051","37.3","11958","54529"
"733",37,2017,"607","310","126","70","54835","20264","2.71","481","-105","32514","37.7","12250","54905"
"734",37,2018,"575","427","140","70","54821","20284","2.7","435","-449","32866","38.3","12582","54891"
"735",37,2019,"557","375","145","70","55000","20366","2.7","412","-233","33296","38.8","12930","55070"
"736",39,1985,"109","184","42","35","8525","2908","2.93","67","233","3520","17.4","612","8560"
"737",39,1986,"129","225","49","35","8758","3007","2.91","80","153","3712","19","705","8793"
"738",39,1987,"147","160","40","37","9303","3199","2.91","107","440","3945","18.9","746","9340"
"739",39,1988,"125","137","43","37","9792","3370","2.91","82","407","4110","18","740","9829"
"740",39,1989,"122","100","56","36","9689","3349","2.89","66","-170","4243","21.1","894","9725"
"741",39,1990,"156","97","51","45","9718","3377","2.88","105","-67","3997","15.5","620","9763"
"742",39,1991,"141","102","53","46","10222","3637","2.81","88","417","4094","11.2","457","10268"
"743",39,1992,"152","194","51","47","10719","3662","2.93","101","397","4196","12.7","534","10766"
"744",39,1993,"111","368","53","52","11490","4084","2.81","58","718","4390","7","306","11542"
"745",39,1994,"155","558","66","61","12786","4537","2.82","89","1216","4758","4.6","221","12847"
"746",39,1995,"179","494","53","54","14274","5081","2.81","126","1355","5316","4.4","235","14328"
"747",39,1996,"182","418","60","52","15754","5652","2.79","122","1356","5835","3.1","183","15806"
"748",39,1997,"192","316","75","56","16931","6139","2.76","117","1064","6253","1.8","114","16987"
"749",39,1998,"217","311","69","56","17976","6538","2.75","148","897","6569","0.5","31","18032"
"750",39,1999,"216","291","63","56","19031","6866","2.77","153","902","6880","0.2","14","19087"
"751",39,2000,"208","77","91","35","20069","6859","2.93","117","901","7186","4.6","327","20104"
"752",39,2001,"256","308","83","35","21259","7311","2.91","173","1017","7486","2.3","175","21294"
"753",39,2002,"236","297","91","35","21569","7464","2.89","145","165","7772","4","308","21604"
"754",39,2003,"214","191","89","37","21896","7624","2.87","125","204","7948","4.1","324","21933"
"755",39,2004,"215","162","111","47","21994","7709","2.85","104","4","8099","4.8","390","22041"
"756",39,2005,"202","213","89","53","22206","7832","2.84","113","105","8297","5.6","465","22259"
"757",39,2006,"196","248","86","53","22474","7979","2.82","110","158","8535","6.5","556","22527"
"758",39,2007,"204","232","94","53","22425","8015","2.8","110","-159","8756","8.5","741","22478"
"759",39,2008,"164","142","124","53","22610","8135","2.78","40","145","8887","8.5","752","22663"
"760",39,2009,"185","55","117","53","22837","8273","2.76","68","159","8916","7.2","643","22890"
"761",39,2010,"163","10","107","73","23034","8388","2.75","56","161","8949","6.3","561","23107"
"762",39,2011,"174","33","107","73","23066","8399","2.75","67","-35","8981","6.5","582","23139"
"763",39,2012,"171","30","116","73","23173","8439","2.75","55","52","9010","6.3","571","23246"
"764",39,2013,"156","44","133","73","23430","8532","2.75","23","234","9053","5.8","521","23503"
"765",39,2014,"179","78","120","73","23923","8711","2.75","59","434","9129","4.6","418","23996"
"766",39,2015,"208","115","138","73","24524","8930","2.75","70","531","9241","3.4","311","24597"
"767",39,2016,"201","150","124","73","25039","9116","2.75","77","438","9387","2.9","271","25112"
"768",39,2017,"222","120","154","73","25660","9341","2.75","68","553","9504","1.7","163","25733"
"769",39,2018,"197","163","149","73","26199","9537","2.75","48","491","9664","1.3","127","26272"
"770",39,2019,"195","217","162","73","26613","9687","2.75","33","381","9898","2.1","211","26686"
"771",41,1985,"7055","6499","1851","17384","351122","133562","2.63","5204","8645","149466","10.6","15904","368506"
"772",41,1986,"7592","6364","2010","17872","361432","138529","2.61","5582","5216","156153","11.3","17624","379304"
"773",41,1987,"7642","2661","2118","18554","374166","144240","2.59","5524","7892","162616","11.3","18376","392720"
"774",41,1988,"7657","1525","2068","20592","374673","145431","2.58","5589","-3044","165354","12.1","19923","395265"
"775",41,1989,"7613","854","2172","19366","376948","147299","2.56","5441","-4392","166667","11.6","19368","396314"
"776",41,1990,"7343","1025","2134","15554","382333","146965","2.6","5209","-3636","165056","11","18091","397887"
"777",41,1991,"7289","1187","2260","15447","390507","147907","2.64","5029","3038","166081","10.9","18174","405954"
"778",41,1992,"7498","2789","2204","16052","406763","154318","2.64","5294","11567","167268","7.7","12950","422815"
"779",41,1993,"7479","3682","2324","16644","420491","160771","2.62","5155","9165","170159","5.5","9388","437135"
"780",41,1994,"7444","3764","2326","17237","439263","166447","2.64","5118","14247","173741","4.2","7294","456500"
"781",41,1995,"7763","4723","2432","17822","451871","170856","2.64","5331","7862","177505","3.8","6649","469693"
"782",41,1996,"7611","5291","2558","17627","459362","174384","2.63","5053","2243","182530","4.5","8146","476989"
"783",41,1997,"7744","4792","2694","19211","467594","178758","2.62","5050","4766","187987","4.9","9229","486805"
"784",41,1998,"7738","4953","2729","19539","478482","182589","2.62","5009","6207","193073","5.4","10484","498021"
"785",41,1999,"8041","5536","2819","19867","488948","186150","2.63","5222","5572","198250","6.1","12100","508815"
"786",41,2000,"8276","1522","2914","15396","504406","193554","2.61","5362","5631","204091","5.2","10537","519802"
"787",41,2001,"8338","6087","2999","15502","520834","200185","2.6","5339","11195","211168","5.2","10983","536336"
"788",41,2002,"8703","6923","3125","15428","529812","204070","2.6","5578","3326","217845","6.3","13775","545240"
"789",41,2003,"8420","6627","3215","15429","536239","206723","2.59","5205","1223","226996","8.9","20273","551668"
"790",41,2004,"8234","5103","3378","15526","542929","209755","2.59","4856","1931","233118","10","23363","558455"
"791",41,2005,"8543","6318","3252","15560","553762","214275","2.58","5291","5576","239367","10.5","25092","569322"
"792",41,2006,"8624","6529","3430","16080","566422","219699","2.58","5194","7986","244173","10","24474","582502"
"793",41,2007,"8921","4197","3354","16022","572750","222624","2.57","5567","703","247960","10.2","25336","588772"
"794",41,2008,"9043","2926","3464","16080","582980","227125","2.57","5579","4709","250335","9.3","23210","599060"
"795",41,2009,"8587","1905","3513","16255","592263","231329","2.56","5074","4384","251891","8.2","20562","608518"
"796",41,2010,"9002","333","3526","19141","608091","237924","2.56","5476","13238","253716","6.2","15792","627232"
"797",41,2011,"9231","1388","3651","20222","618418","241949","2.56","5580","5828","255006","5.1","13057","638640"
"798",41,2012,"9156","1843","3781","20001","627428","245427","2.56","5375","3414","256753","4.4","11326","647429"
"799",41,2013,"9086","2879","3940","20279","636495","248900","2.56","5146","4199","259328","4","10428","656774"
"800",41,2014,"9181","3379","4050","20175","643773","251683","2.56","5131","2043","262585","4.2","10902","663948"
"801",41,2015,"9435","3317","4160","20568","655077","256050","2.56","5275","6422","265772","3.7","9722","675645"
"802",41,2016,"9473","3102","4327","21080","668401","261240","2.56","5146","8690","268720","2.8","7480","689481"
"803",41,2017,"9474","3506","4674","21024","680339","265779","2.56","4800","7082","272124","2.3","6345","701363"
"804",41,2018,"9336","3598","4651","21028","693358","270739","2.56","4685","8338","275547","1.7","4808","714386"
"805",41,2019,"9119","5586","4724","21024","701469","273847","2.56","4395","3712","279029","1.9","5182","722493"
"806",43,1985,"364","259","374","2749","28617","10955","2.61","-10","93","13085","16.3","2130","31366"
"807",43,1986,"401","261","344","2687","28443","10868","2.62","57","-293","13450","19.2","2582","31130"
"808",43,1987,"364","110","358","2697","28697","10955","2.62","6","258","13761","20.4","2806","31394"
"809",43,1988,"350","78","415","3583","28310","10830","2.61","-65","564","13897","22.1","3067","31893"
"810",43,1989,"366","122","399","4037","28077","10732","2.62","-33","254","14600","26.5","3868","32114"
"811",43,1990,"312","127","429","3903","28297","11713","2.42","-117","203","13683","14.4","1970","32200"
"812",43,1991,"336","81","402","3734","28503","11609","2.46","-66","103","13837","16.1","2228","32237"
"813",43,1992,"357","169","407","3911","29907","11768","2.54","-50","1631","13923","15.5","2155","33818"
"814",43,1993,"391","209","420","5854","30653","12579","2.44","-29","2718","14105","10.8","1526","36507"
"815",43,1994,"384","277","396","6831","31874","12565","2.54","-12","2210","14336","12.4","1771","38705"
"816",43,1995,"418","336","479","8080","32442","12776","2.54","-61","1878","14635","12.7","1859","40522"
"817",43,1996,"448","241","514","11970","29858","11726","2.55","-66","1372","14971","21.7","3245","41828"
"818",43,1997,"444","327","448","8295","34549","13489","2.56","-4","1020","15212","11.3","1723","42844"
"819",43,1998,"406","356","470","8745","35068","13666","2.57","-64","1033","15539","12.1","1873","43813"
"820",43,1999,"445","416","476","9195","35949","13930","2.58","-31","1362","15895","12.4","1965","45144"
"821",43,2000,"473","94","462","9143","37227","15344","2.43","11","1224","17230","11","1886","46370"
"822",43,2001,"446","374","479","9061","37672","15616","2.41","-33","396","17347","10","1731","46733"
"823",43,2002,"404","360","464","9109","37860","15781","2.4","-60","296","17559","10.1","1778","46969"
"824",43,2003,"420","239","516","9164","37664","15783","2.39","-96","-45","17692","10.8","1909","46828"
"825",43,2004,"401","296","494","9280","37260","15701","2.37","-93","-195","17975","12.7","2274","46540"
"826",43,2005,"402","215","493","9243","37204","15764","2.36","-91","-2","18191","13.3","2427","46447"
"827",43,2006,"439","262","483","9219","37484","15969","2.35","-44","300","18444","13.4","2475","46703"
"828",43,2007,"422","235","516","9197","37457","16045","2.33","-94","45","18685","14.1","2640","46654"
"829",43,2008,"425","154","458","9347","37427","16124","2.32","-33","153","18925","14.8","2801","46774"
"830",43,2009,"413","91","491","9305","37330","16169","2.31","-78","-61","19104","15.4","2935","46635"
"831",43,2010,"373","12","504","8704","38150","16595","2.3","-131","350","19261","13.8","2666","46854"
"832",43,2011,"379","53","528","9058","38376","16591","2.31","-149","729","19349","14.3","2758","47434"
"833",43,2012,"388","46","498","8681","38409","16605","2.31","-110","-234","19393","14.4","2788","47090"
"834",43,2013,"335","52","529","8364","37971","16417","2.31","-194","-561","19444","15.6","3027","46335"
"835",43,2014,"380","53","541","8211","37935","16402","2.31","-161","-28","19495","15.9","3093","46146"
"836",43,2015,"381","55","546","8151","38132","16485","2.31","-165","302","19548","15.7","3063","46283"
"837",43,2016,"379","54","541","8299","38696","16730","2.31","-162","874","19597","14.6","2867","46995"
"838",43,2017,"379","85","575","8443","39147","16925","2.31","-196","791","19701","14.1","2776","47590"
"839",43,2018,"375","119","562","8319","39570","17110","2.31","-187","486","19824","13.7","2714","47889"
"840",43,2019,"383","137","580","8443","39202","17050","2.3","-197","-47","19967","14.6","2917","47645"
"841",45,1985,"467","56","172","444","25270","9426","2.68","295","-238","12647","25.5","3221","25714"
"842",45,1986,"441","22","173","448","25743","9638","2.67","268","209","12265","21.4","2627","26191"
"843",45,1987,"424","68","193","451","25936","9728","2.67","231","-35","12078","19.5","2350","26387"
"844",45,1988,"418","111","178","645","26680","9944","2.68","240","698","12166","18.3","2222","27325"
"845",45,1989,"445","182","206","725","28084","10490","2.68","239","1245","12290","14.7","1800","28809"
"846",45,1990,"493","216","192","691","29460","11266","2.61","301","1041","12517","10","1251","30151"
"847",45,1991,"495","132","210","721","30509","11812","2.58","285","794","12733","7.2","921","31230"
"848",45,1992,"462","327","188","714","30625","11868","2.58","274","-165","12880","7.9","1012","31339"
"849",45,1993,"426","376","204","749","31825","12142","2.62","222","1013","13220","8.2","1078","32574"
"850",45,1994,"465","533","212","768","33728","12737","2.65","253","1669","13648","6.7","911","34496"
"851",45,1995,"498","406","229","807","35610","13407","2.66","269","1652","14181","5.5","774","36417"
"852",45,1996,"561","384","230","837","36840","13876","2.65","331","929","14695","5.6","819","37677"
"853",45,1997,"603","403","250","876","38018","14332","2.65","353","864","15131","5.3","799","38894"
"854",45,1998,"580","497","237","961","40270","14936","2.7","343","1994","15534","3.9","598","41231"
"855",45,1999,"676","635","256","1046","41645","15455","2.69","420","1040","16097","4","642","42691"
"856",45,2000,"733","164","242","849","43391","16387","2.65","491","1055","17521","6.5","1134","44240"
"857",45,2001,"796","655","269","850","45057","16962","2.66","527","1140","18229","7","1267","45907"
"858",45,2002,"811","546","282","848","45880","17228","2.66","529","292","18927","9","1699","46728"
"859",45,2003,"866","508","288","849","46635","17459","2.67","578","178","19525","10.6","2066","47484"
"860",45,2004,"811","356","275","843","47313","17660","2.68","536","136","20008","11.7","2348","48156"
"861",45,2005,"832","485","271","848","48408","18011","2.69","561","539","20598","12.6","2587","49256"
"862",45,2006,"893","569","274","852","50254","18643","2.7","619","1231","21230","12.2","2587","51106"
"863",45,2007,"971","718","290","847","51829","19162","2.7","681","889","22106","13.3","2944","52676"
"864",45,2008,"975","574","286","830","53396","19680","2.71","689","861","22805","13.7","3125","54226"
"865",45,2009,"997","385","268","851","54549","20048","2.72","729","445","23145","13.4","3097","55400"
"866",45,2010,"912","20","278","884","55266","20272","2.73","634","116","23329","13.1","3057","56150"
"867",45,2011,"863","37","294","868","55245","20264","2.73","569","-606","23370","13.3","3106","56113"
"868",45,2012,"788","33","252","884","55961","20525","2.73","536","196","23405","12.3","2880","56845"
"869",45,2013,"822","96","281","849","56169","20606","2.73","541","-368","23499","12.3","2893","57018"
"870",45,2014,"773","76","288","883","56370","20678","2.73","485","-250","23581","12.3","2903","57253"
"871",45,2015,"767","83","338","875","56923","20878","2.73","429","116","23668","11.8","2790","57798"
"872",45,2016,"839","144","337","884","58046","21287","2.73","502","630","23866","10.8","2579","58930"
"873",45,2017,"823","166","322","880","58265","21366","2.73","501","-286","24033","11.1","2667","59145"
"874",45,2018,"781","194","340","880","58947","21609","2.73","441","241","24232","10.8","2623","59827"
"875",45,2019,"754","189","376","880","59288","21729","2.73","378","-37","24408","11","2679","60168"
"876",47,1985,"41","36","17","51","3030","1128","2.69","24","31","2185","48.4","1057","3081"
"877",47,1986,"41","24","12","53","3184","1170","2.72","29","127","2219","47.3","1049","3237"
"878",47,1987,"58","16","10","53","3226","1162","2.78","48","-6","2240","48.1","1078","3279"
"879",47,1988,"41","16","13","51","3121","1110","2.81","28","-135","2256","50.8","1146","3172"
"880",47,1989,"41","20","10","50","3064","1078","2.84","31","-89","2265","52.4","1187","3114"
"881",47,1990,"34","16","11","2","3067","1308","2.34","23","-68","2438","46.4","1130","3069"
"882",47,1991,"31","17","15","2","3087","1327","2.33","16","4","2454","45.9","1127","3089"
"883",47,1992,"32","34","22","2","3242","1382","2.35","10","145","2471","44.1","1089","3244"
"884",47,1993,"40","32","13","2","3374","1438","2.35","27","105","2505","42.6","1067","3376"
"885",47,1994,"37","58","14","2","3497","1487","2.35","23","100","2537","41.4","1050","3499"
"886",47,1995,"45","67","16","2","3666","1561","2.35","29","140","2595","39.9","1034","3668"
"887",47,1996,"48","254","13","2","3790","1618","2.34","35","89","2662","39.2","1044","3792"
"888",47,1997,"41","80","14","3","4032","1750","2.3","27","216","2916","40","1166","4035"
"889",47,1998,"48","86","13","3","4243","1841","2.3","35","176","2996","38.6","1155","4246"
"890",47,1999,"46","81","16","3","4535","1937","2.34","30","262","3082","37.2","1145","4538"
"891",47,2000,"72","20","17","24","4779","2066","2.31","55","210","2950","30","884","4803"
"892",47,2001,"57","81","15","24","4805","2088","2.3","42","-16","3035","31.2","947","4829"
"893",47,2002,"66","63","26","24","4806","2099","2.29","40","-39","3102","32.3","1003","4830"
"894",47,2003,"53","69","31","24","4827","2118","2.28","22","-1","3175","33.3","1057","4851"
"895",47,2004,"56","54","26","46","4779","2107","2.27","30","-56","3234","34.9","1127","4825"
"896",47,2005,"55","73","20","52","4840","2145","2.26","35","32","3312","35.2","1167","4892"
"897",47,2006,"73","83","28","45","4908","2190","2.24","45","16","3401","35.6","1211","4953"
"898",47,2007,"58","72","19","37","4927","2211","2.23","39","-28","3479","36.5","1268","4964"
"899",47,2008,"49","39","30","37","5047","2279","2.21","19","101","3524","35.3","1245","5084"
"900",47,2009,"52","44","26","37","5359","2435","2.2","26","286","3545","31.3","1110","5396"
"901",47,2010,"47","4","25","49","5414","2471","2.19","22","45","3564","30.7","1093","5463"
"902",47,2011,"47","4","28","49","5372","2450","2.19","19","-61","3568","31.3","1118","5421"
"903",47,2012,"39","16","27","49","5374","2452","2.19","12","-10","3584","31.6","1132","5423"
"904",47,2013,"48","8","21","49","5473","2497","2.19","27","72","3592","30.5","1095","5522"
"905",47,2014,"40","14","30","49","5690","2597","2.19","10","207","3606","28","1009","5739"
"906",47,2015,"39","13","34","49","5748","2623","2.19","5","53","3619","27.5","996","5797"
"907",47,2016,"42","16","30","49","5857","2673","2.19","12","97","3635","26.5","962","5906"
"908",47,2017,"40","31","30","49","5959","2727","2.19","10","92","3675","25.8","948","6008"
"909",47,2018,"42","55","23","49","6055","2772","2.18","19","77","3729","25.7","957","6104"
"910",47,2019,"15","41","24","49","6166","2822","2.18","-9","120","3767","25.1","945","6215"
"911",49,1985,"144","160","41","9","9203","3751","2.45","103","218","9948","62.3","6197","9212"
"912",49,1986,"157","96","30","9","9130","3785","2.41","127","-200","10113","62.6","6328","9139"
"913",49,1987,"122","77","37","9","8899","3749","2.37","85","-316","10213","63.3","6464","8908"
"914",49,1988,"104","44","29","9","8458","3620","2.34","75","-516","10301","64.9","6681","8467"
"915",49,1989,"110","38","40","9","8169","3556","2.3","70","-359","10305","65.5","6749","8178"
"916",49,1990,"120","63","32","75","7931","3168","2.5","88","-260","9985","68.3","6817","8006"
"917",49,1991,"100","61","35","73","8316","3129","2.66","65","318","10048","68.9","6919","8389"
"918",49,1992,"90","89","33","72","8532","3046","2.8","57","158","10109","69.9","7063","8604"
"919",49,1993,"86","129","40","80","8845","3376","2.62","46","275","10198","66.9","6822","8925"
"920",49,1994,"91","273","40","82","9257","3465","2.67","51","363","10327","66.5","6862","9339"
"921",49,1995,"117","247","33","87","9866","3645","2.71","84","530","10600","65.6","6955","9953"
"922",49,1996,"111","282","44","90","10421","3808","2.74","67","491","10847","64.9","7039","10511"
"923",49,1997,"124","364","42","92","10874","3949","2.75","82","373","11129","64.5","7180","10966"
"924",49,1998,"134","644","42","92","11317","4055","2.79","92","351","11493","64.7","7438","11409"
"925",49,1999,"136","485","55","92","11903","4208","2.83","81","505","12137","65.3","7929","11995"
"926",49,2000,"150","132","59","393","12460","5255","2.37","91","766","12198","56.9","6943","12853"
"927",49,2001,"153","529","62","393","12890","5464","2.36","91","339","12716","57","7252","13283"
"928",49,2002,"159","466","67","393","13068","5562","2.35","92","86","13169","57.8","7607","13461"
"929",49,2003,"163","348","54","393","13295","5682","2.34","109","118","13267","57.2","7585","13688"
"930",49,2004,"142","432","40","393","13519","5798","2.33","102","122","13662","57.6","7864","13912"
"931",49,2005,"146","513","73","393","13504","5813","2.32","73","-88","14074","58.7","8261","13897"
"932",49,2006,"139","606","59","393","13742","5939","2.31","80","158","14541","59.2","8602","14135"
"933",49,2007,"170","792","49","393","13946","6053","2.3","121","83","15327","60.5","9274","14339"
"934",49,2008,"156","574","57","393","14142","6163","2.29","99","97","15786","61","9623","14535"
"935",49,2009,"145","313","54","393","14271","6248","2.28","91","38","15980","60.9","9732","14664"
"936",49,2010,"138","35","44","222","14568","6444","2.26","94","32","16094","60","9650","14790"
"937",49,2011,"106","64","66","222","14337","6343","2.26","40","-271","16175","60.8","9832","14559"
"938",49,2012,"111","49","45","222","13995","6188","2.26","66","-408","16302","62","10114","14217"
"939",49,2013,"117","34","61","222","14086","6230","2.26","56","35","16365","61.9","10135","14308"
"940",49,2014,"123","39","66","222","14334","6360","2.25","57","191","16392","61.2","10032","14556"
"941",49,2015,"113","68","77","222","14504","6444","2.25","36","134","16455","60.8","10011","14726"
"942",49,2016,"127","130","66","222","14957","6651","2.25","61","392","16579","59.8","9928","15179"
"943",49,2017,"129","158","67","222","15141","6730","2.25","62","122","16732","59.7","10002","15363"
"944",49,2018,"107","185","85","222","15279","6791","2.25","22","116","16908","59.7","10117","15501"
"945",49,2019,"109","213","75","222","15496","6886","2.25","34","183","17110","59.7","10224","15718"
"946",51,1985,"140","87","50","1399","8991","4072","2.21","90","-117","7165","43.2","3093","10390"
"947",51,1986,"149","117","51","1472","9418","4368","2.16","98","402","7243","39.7","2875","10890"
"948",51,1987,"126","119","58","1485","9370","4448","2.11","68","-103","7350","39.5","2902","10855"
"949",51,1988,"129","126","52","1032","9795","4525","2.16","77","-105","7477","39.5","2952","10827"
"950",51,1989,"126","123","36","989","9520","4507","2.11","90","-408","7544","40.3","3037","10509"
"951",51,1990,"127","163","47","1087","9194","3855","2.38","80","-308","7294","47.2","3439","10281"
"952",51,1991,"124","166","47","1078","9338","3984","2.34","77","58","7457","46.6","3473","10416"
"953",51,1992,"122","233","50","1139","9637","4274","2.25","72","288","7623","43.9","3349","10776"
"954",51,1993,"138","257","57","1327","9984","4325","2.31","81","454","7856","45","3531","11311"
"955",51,1994,"124","339","43","1235","10436","4565","2.29","81","279","8113","43.7","3548","11671"
"956",51,1995,"91","325","59","1182","10792","4721","2.29","32","271","8452","44.1","3731","11974"
"957",51,1996,"129","235","49","1110","11134","4872","2.29","80","190","8777","44.5","3905","12244"
"958",51,1997,"118","276","61","1074","11331","4992","2.27","57","104","9012","44.6","4020","12405"
"959",51,1998,"134","260","33","1079","12363","5083","2.43","101","936","9288","45.3","4205","13442"
"960",51,1999,"130","309","48","1084","12652","5472","2.31","82","212","9660","43.4","4188","13736"
"961",51,2000,"155","80","53","975","13014","5667","2.3","102","151","9222","38.6","3555","13989"
"962",51,2001,"186","321","66","1039","13306","5810","2.29","120","236","9571","39.3","3761","14345"
"963",51,2002,"171","194","71","1113","13203","5786","2.28","100","-129","9793","40.9","4007","14316"
"964",51,2003,"178","194","73","1066","13140","5775","2.28","105","-215","10020","42.4","4245","14206"
"965",51,2004,"165","191","70","897","13333","5884","2.27","95","-71","10244","42.6","4360","14230"
"966",51,2005,"168","192","73","839","13634","6035","2.26","95","148","10456","42.3","4421","14473"
"967",51,2006,"158","262","51","841","13809","6134","2.25","107","70","10738","42.9","4604","14650"
"968",51,2007,"162","243","49","830","14127","6298","2.24","113","194","11002","42.8","4704","14957"
"969",51,2008,"168","173","66","808","14329","6412","2.23","102","78","11214","42.8","4802","15137"
"970",51,2009,"182","87","59","808","14458","6493","2.23","123","6","11338","42.7","4846","15266"
"971",51,2010,"158","22","69","850","14459","6511","2.22","89","-46","11431","43","4920","15309"
"972",51,2011,"152","73","58","868","14541","6548","2.22","94","6","11452","42.8","4904","15409"
"973",51,2012,"164","50","74","824","14569","6560","2.22","90","-106","11467","42.8","4907","15393"
"974",51,2013,"149","47","65","1002","14604","6576","2.22","84","129","11486","42.7","4910","15606"
"975",51,2014,"136","64","54","991","14806","6669","2.22","82","109","11512","42.1","4843","15797"
"976",51,2015,"138","58","79","989","15145","6820","2.22","59","278","11533","40.9","4713","16134"
"977",51,2016,"158","98","79","1019","15430","6951","2.22","79","236","11562","39.9","4611","16449"
"978",51,2017,"135","103","67","1032","15859","7142","2.22","68","374","11660","38.7","4518","16891"
"979",51,2018,"126","142","81","1032","16156","7278","2.22","45","252","11796","38.3","4518","17188"
"980",51,2019,"131","169","63","1032","16463","7416","2.22","68","239","11916","37.8","4500","17495"
"981",53,1985,"5","20","0","0","472","168","2.81","5","-116","888","81.1","720","472"
"982",53,1986,"6","4","3","0","468","165","2.84","3","-7","908","81.8","743","468"
"983",53,1987,"8","15","0","0","508","176","2.89","6","32","913","80.7","737","508"
"984",53,1988,"3","19","4","0","489","166","2.95","-1","-18","929","82.1","763","489"
"985",53,1989,"5","10","4","0","476","160","2.98","1","-14","987","83.8","827","476"
"986",53,1990,"3","13","3","0","463","214","2.16","0","-13","1254","82.9","1040","463"
"987",53,1991,"3","7","0","0","453","199","2.28","3","-13","1267","84.3","1068","453"
"988",53,1992,"4","12","0","0","504","210","2.4","4","47","1274","83.5","1064","504"
"989",53,1993,"9","19","0","0","546","245","2.23","9","33","1286","81","1041","546"
"990",53,1994,"5","32","0","0","612","274","2.23","5","61","1305","79","1031","612"
"991",53,1995,"3","17","4","0","659","294","2.24","-1","48","1337","78","1043","659"
"992",53,1996,"7","29","3","0","707","314","2.25","4","44","1354","76.8","1040","707"
"993",53,1997,"4","20","4","0","739","330","2.24","0","32","1383","76.1","1053","739"
"994",53,1998,"6","13","0","0","776","345","2.25","6","31","1403","75.4","1058","776"
"995",53,1999,"8","13","4","0","784","345","2.27","4","4","1416","75.6","1071","784"
"996",53,2000,"12","4","0","0","792","360","2.2","12","-7","1307","72.5","947","792"
"997",53,2001,"6","15","4","0","804","366","2.2","2","10","1316","72.2","950","804"
"998",53,2002,"10","16","5","0","806","367","2.2","5","-3","1325","72.3","958","806"
"999",53,2003,"5","14","1","0","784","358","2.19","4","-26","1333","73.1","975","784"
"1000",53,2004,"8","8","1","0","831","380","2.19","7","40","1335","71.5","955","831"
"1001",53,2005,"8","15","2","0","813","372","2.19","6","-24","1343","72.3","971","813"
"1002",53,2006,"7","17","5","0","830","380","2.18","2","15","1356","72","976","830"
"1003",53,2007,"9","12","1","0","845","388","2.18","8","7","1363","71.5","975","845"
"1004",53,2008,"8","27","2","0","824","378","2.18","6","-27","1383","72.7","1005","824"
"1005",53,2009,"10","17","2","0","827","380","2.18","8","-5","1386","72.6","1006","827"
"1006",53,2010,"10","2","4","56","787","362","2.17","6","10","1391","74","1029","843"
"1007",53,2011,"5","1","7","56","768","353","2.18","-2","-17","1392","74.6","1039","824"
"1008",53,2012,"6","6","3","56","745","342","2.18","3","-26","1398","75.5","1056","801"
"1009",53,2013,"10","3","5","56","748","344","2.17","5","-2","1401","75.4","1057","804"
"1010",53,2014,"6","4","4","56","715","329","2.17","2","-35","1405","76.6","1076","771"
"1011",53,2015,"7","4","5","56","708","325","2.18","2","-9","1409","76.9","1084","764"
"1012",53,2016,"2","6","4","56","730","335","2.18","-2","24","1415","76.3","1080","786"
"1013",53,2017,"4","7","4","56","736","339","2.17","0","6","1422","76.2","1083","792"
"1014",53,2018,"1","8","7","56","750","345","2.17","-6","20","1430","75.9","1085","806"
"1015",53,2019,"0","9","0","56","763","350","2.18","0","13","1438","75.7","1088","819"
"1016",55,1985,"85","38","81","144","6665","2778","2.4","4","165","4123","32.6","1345","6809"
"1017",55,1986,"83","31","80","144","6608","2811","2.35","3","-60","4179","32.7","1368","6752"
"1018",55,1987,"71","70","69","142","6358","2757","2.31","2","-254","4227","34.8","1470","6500"
"1019",55,1988,"78","18","68","138","6154","2722","2.26","10","-218","4302","36.7","1580","6292"
"1020",55,1989,"59","17","86","137","5993","2704","2.22","-27","-135","4334","37.6","1630","6130"
"1021",55,1990,"61","11","71","116","5888","2446","2.41","-10","-116","3913","37.5","1467","6004"
"1022",55,1991,"59","14","81","108","5949","2307","2.58","-22","75","3929","41.3","1622","6057"
"1023",55,1992,"59","23","67","109","6072","2306","2.63","-8","132","3943","41.5","1637","6181"
"1024",55,1993,"69","26","88","123","6316","2597","2.43","-19","277","3966","34.5","1369","6439"
"1025",55,1994,"67","60","70","132","6791","2777","2.45","-3","487","3992","30.4","1215","6923"
"1026",55,1995,"62","71","88","136","7026","2865","2.45","-26","265","4052","29.3","1187","7162"
"1027",55,1996,"50","96","89","140","7249","2951","2.46","-39","266","4123","28.4","1172","7389"
"1028",55,1997,"65","107","84","145","7527","3077","2.45","-19","302","4219","27.1","1142","7672"
"1029",55,1998,"64","109","102","892","6889","2823","2.44","-38","147","4326","34.7","1503","7781"
"1030",55,1999,"70","115","97","1639","6188","2535","2.44","-27","73","4435","42.8","1900","7827"
"1031",55,2000,"71","23","92","919","6908","3072","2.25","-21","18","4620","33.5","1548","7827"
"1032",55,2001,"74","93","89","1061","6844","3065","2.23","-15","93","4705","34.9","1640","7905"
"1033",55,2002,"83","90","98","1035","6881","3104","2.22","-15","26","4787","35.2","1683","7916"
"1034",55,2003,"79","60","112","1165","6877","3126","2.2","-33","159","4837","35.4","1711","8042"
"1035",55,2004,"73","50","88","1086","6643","3043","2.18","-15","-298","4878","37.6","1835","7729"
"1036",55,2005,"61","51","95","1167","6656","3073","2.17","-34","128","4918","37.5","1845","7823"
"1037",55,2006,"58","38","92","1173","6577","3059","2.15","-34","-39","4946","38.2","1887","7750"
"1038",55,2007,"58","47","92","1167","6491","3043","2.13","-34","-58","4984","38.9","1941","7658"
"1039",55,2008,"59","62","119","1183","6497","3071","2.12","-60","82","5035","39","1964","7680"
"1040",55,2009,"56","32","108","418","6292","2998","2.1","-52","-918","5056","40.7","2058","6710"
"1041",55,2010,"56","9","102","165","6490","3110","2.09","-46","-9","5084","38.8","1974","6655"
"1042",55,2011,"46","30","105","165","6340","3038","2.09","-59","-91","5113","40.6","2075","6505"
"1043",55,2012,"59","30","106","165","6378","3055","2.09","-47","85","5141","40.6","2086","6543"
"1044",55,2013,"50","24","88","165","6282","3010","2.09","-38","-58","5162","41.7","2152","6447"
"1045",55,2014,"41","15","97","165","6211","2976","2.09","-56","-15","5170","42.4","2194","6376"
"1046",55,2015,"55","14","104","165","6221","2982","2.09","-49","59","5182","42.5","2200","6386"
"1047",55,2016,"44","32","109","165","6403","3068","2.09","-65","247","5210","41.1","2142","6568"
"1048",55,2017,"44","31","117","165","6454","3093","2.09","-73","124","5239","41","2146","6619"
"1049",55,2018,"45","33","100","165","6699","3210","2.09","-55","300","5276","39.2","2066","6864"
"1050",55,2019,"41","38","109","165","6689","3206","2.09","-68","58","5313","39.7","2107","6854"
"1051",57,1985,"28","7","7","19","1710","600","2.85","21","-85","1166","48.5","566","1729"
"1052",57,1986,"19","8","7","18","1690","592","2.85","12","-33","1170","49.4","578","1708"
"1053",57,1987,"20","12","12","19","1756","612","2.87","8","59","1175","47.9","563","1775"
"1054",57,1988,"17","5","16","18","1695","588","2.88","1","-63","1189","50.6","601","1713"
"1055",57,1989,"21","6","9","17","1634","566","2.89","12","-74","1232","54.1","666","1651"
"1056",57,1990,"23","11","14","11","1586","632","2.51","9","-63","1326","52.3","694","1597"
"1057",57,1991,"16","2","7","10","1546","619","2.5","9","-50","1337","53.7","718","1556"
"1058",57,1992,"22","3","11","10","1564","603","2.59","11","7","1339","55","736","1574"
"1059",57,1993,"21","6","16","12","1620","673","2.41","5","53","1342","49.9","669","1632"
"1060",57,1994,"22","13","16","12","1630","682","2.39","6","4","1348","49.4","666","1642"
"1061",57,1995,"13","17","10","12","1597","679","2.35","3","-36","1361","50.1","682","1609"
"1062",57,1996,"12","25","11","12","1582","685","2.31","1","-16","1378","50.3","693","1594"
"1063",57,1997,"16","14","11","12","1584","701","2.26","5","-3","1403","50","702","1596"
"1064",57,1998,"16","17","16","12","1575","708","2.22","0","-9","1417","50","709","1587"
"1065",57,1999,"18","16","11","12","1570","717","2.19","7","-12","1434","50","717","1582"
"1066",57,2000,"12","6","7","10","1566","662","2.37","5","-9","1151","42.5","489","1576"
"1067",57,2001,"17","23","18","10","1580","675","2.34","-1","15","1176","42.6","501","1590"
"1068",57,2002,"18","16","10","10","1581","680","2.33","8","-7","1193","43","513","1591"
"1069",57,2003,"12","9","12","10","1576","685","2.3","0","-5","1204","43.1","519","1586"
"1070",57,2004,"10","14","8","10","1511","664","2.28","2","-67","1219","45.5","555","1521"
"1071",57,2005,"9","10","12","10","1482","657","2.26","-3","-26","1231","46.6","574","1492"
"1072",57,2006,"15","13","12","10","1433","642","2.23","3","-52","1246","48.5","604","1443"
"1073",57,2007,"12","12","11","10","1412","638","2.21","1","-22","1260","49.4","622","1422"
"1074",57,2008,"11","8","13","10","1371","627","2.19","-2","-39","1270","50.6","643","1381"
"1075",57,2009,"8","12","14","10","1376","636","2.16","-6","11","1280","50.3","644","1386"
"1076",57,2010,"10","2","7","2","1385","646","2.14","3","-2","1288","49.8","642","1387"
"1077",57,2011,"12","7","10","2","1354","631","2.15","2","-33","1295","51.3","664","1356"
"1078",57,2012,"9","2","15","2","1322","616","2.15","-6","-26","1297","52.5","681","1324"
"1079",57,2013,"6","2","10","2","1334","622","2.14","-4","16","1299","52.1","677","1336"
"1080",57,2014,"17","4","12","2","1383","645","2.14","5","44","1303","50.5","658","1385"
"1081",57,2015,"12","5","10","2","1350","629","2.15","2","-35","1309","51.9","680","1352"
"1082",57,2016,"12","4","12","2","1355","631","2.15","0","5","1313","51.9","682","1357"
"1083",57,2017,"15","7","13","2","1374","640","2.15","2","17","1320","51.5","680","1376"
"1084",57,2018,"13","9","15","2","1391","648","2.15","-2","19","1327","51.2","679","1393"
"1085",57,2019,"6","5","7","2","1381","644","2.14","-1","-9","1334","51.7","690","1383"
"1086",59,1985,"6675","4909","2182","6206","415411","148723","2.79","4493","3441","163850","9.2","15127","421617"
"1087",59,1986,"6811","4801","2149","6216","420854","151297","2.78","4662","791","168344","10.1","17047","427070"
"1088",59,1987,"6551","2809","2161","6213","423974","152699","2.78","4390","-1273","173123","11.8","20424","430187"
"1089",59,1988,"6587","1525","2419","6201","426228","153871","2.77","4168","-1926","175952","12.6","22081","432429"
"1090",59,1989,"6527","1742","2219","5856","430049","155728","2.76","4308","-832","177967","12.5","22239","435905"
"1091",59,1990,"6711","1734","2419","6482","433403","166545","2.6","4292","-312","178611","6.8","12066","439885"
"1092",59,1991,"6445","2201","2430","6523","443140","170280","2.6","4015","5763","180338","5.6","10058","449663"
"1093",59,1992,"6538","3350","2418","6875","456665","175300","2.61","4120","9757","182919","4.2","7619","463540"
"1094",59,1993,"6513","3761","2597","7055","469153","180710","2.6","3916","8752","186285","3","5575","476208"
"1095",59,1994,"6472","4093","2670","6844","476589","182527","2.61","3802","3423","189667","3.8","7140","483433"
"1096",59,1995,"6352","5102","2712","6904","484410","185470","2.61","3640","4241","193161","4","7691","491314"
"1097",59,1996,"6229","3576","2796","7073","490973","188494","2.6","3433","3299","197664","4.6","9170","498046"
"1098",59,1997,"6372","3686","2965","7151","497083","192227","2.59","3407","2781","201048","4.4","8821","504234"
"1099",59,1998,"6358","3675","3076","7119","505364","194447","2.6","3282","4967","204371","4.9","9924","512483"
"1100",59,1999,"6301","2924","3030","7087","513723","198498","2.59","3271","5056","208057","4.6","9559","520810"
"1101",59,2000,"6701","847","3159","7730","518988","206160","2.52","3542","2365","212761","3.1","6601","526718"
"1102",59,2001,"6532","3387","3133","7788","520279","207436","2.51","3399","-2050","216341","4.1","8905","528067"
"1103",59,2002,"6551","2673","3400","7730","519809","208047","2.5","3151","-3679","218986","5","10939","527539"
"1104",59,2003,"6620","2229","3444","7760","517669","208064","2.49","3176","-5286","221186","5.9","13122","525429"
"1105",59,2004,"6337","1642","3367","7827","517049","208717","2.48","2970","-3523","222899","6.4","14182","524876"
"1106",59,2005,"6183","2535","3338","7797","515720","209058","2.47","2845","-4204","224639","6.9","15581","523517"
"1107",59,2006,"6138","2151","3462","7767","516812","210389","2.46","2676","-1614","226430","7.1","16041","524579"
"1108",59,2007,"6194","2059","3541","7840","519280","212308","2.45","2653","-112","227770","6.8","15463","527120"
"1109",59,2008,"6167","1073","3736","7796","522769","214695","2.43","2431","1014","229029","6.3","14334","530565"
"1110",59,2009,"5934","602","3678","7795","524811","216523","2.42","2256","-215","229781","5.8","13258","532606"
"1111",59,2010,"5723","102","3757","7427","528224","218631","2.42","1966","1079","230181","5","11550","535651"
"1112",59,2011,"5545","610","3744","7723","532894","220561","2.42","1801","3165","230772","4.4","10211","540617"
"1113",59,2012,"5565","990","3906","7575","539041","223102","2.42","1659","4340","231726","3.7","8624","546616"
"1114",59,2013,"5633","1093","4003","7763","544444","225332","2.42","1630","3961","232765","3.2","7433","552207"
"1115",59,2014,"5917","1643","4110","7774","551211","228138","2.42","1807","4971","234054","2.5","5916","558985"
"1116",59,2015,"5838","2621","4397","7815","557303","230691","2.42","1441","4692","236604","2.5","5913","565118"
"1117",59,2016,"5903","1897","4322","7987","563661","233389","2.42","1581","4949","238388","2.1","4999","571648"
"1118",59,2017,"5977","2601","4489","8671","567051","234690","2.42","1488","2586","240911","2.6","6221","575722"
"1119",59,2018,"5589","1993","4521","8320","571321","236473","2.42","1068","2851","242926","2.7","6453","579641"
"1120",59,2019,"5626","2202","4493","8671","574410","237772","2.42","1133","2307","245379","3.1","7607","583081"
"1121",61,1985,"24","0","12","29","1818","728","2.5","12","-123","855","14.9","127","1847"
"1122",61,1986,"22","-1","15","29","1769","717","2.47","7","-56","844","15.1","127","1798"
"1123",61,1987,"25","0","16","28","1730","709","2.44","9","-49","833","14.9","124","1758"
"1124",61,1988,"22","-1","10","28","1683","697","2.41","12","-59","834","16.4","137","1711"
"1125",61,1989,"20","-1","21","28","1670","699","2.39","-1","-12","904","22.7","205","1698"
"1126",61,1990,"16","0","16","44","1644","657","2.5","0","-10","878","25.2","221","1688"
"1127",61,1991,"19","0","21","47","1636","704","2.32","-2","-3","878","19.8","174","1683"
"1128",61,1992,"15","4","19","48","1647","710","2.32","-4","16","878","19.1","168","1695"
"1129",61,1993,"14","0","19","46","1652","677","2.44","-5","8","882","23.2","205","1698"
"1130",61,1994,"16","1","24","46","1647","677","2.43","-8","3","882","23.2","205","1693"
"1131",61,1995,"20","3","10","46","1597","663","2.41","10","-60","883","24.9","220","1643"
"1132",61,1996,"14","1","19","47","1615","679","2.38","-5","24","886","23.4","207","1662"
"1133",61,1997,"17","0","25","47","1614","689","2.34","-8","7","887","22.3","198","1661"
"1134",61,1998,"19","1","18","47","1597","689","2.32","1","-18","887","22.3","198","1644"
"1135",61,1999,"14","1","13","47","1585","690","2.3","1","-13","888","22.3","198","1632"
"1136",61,2000,"16","0","14","24","1590","663","2.4","2","-14","816","18.8","153","1614"
"1137",61,2001,"16","0","25","24","1582","663","2.39","-9","1","813","18.5","150","1606"
"1138",61,2002,"14","1","16","24","1542","651","2.37","-2","-38","811","19.7","160","1566"
"1139",61,2003,"23","0","18","24","1524","649","2.35","5","-23","809","19.8","160","1548"
"1140",61,2004,"11","0","22","24","1499","643","2.33","-11","-14","806","20.2","163","1523"
"1141",61,2005,"16","2","20","28","1515","655","2.31","-4","24","805","18.6","150","1543"
"1142",61,2006,"7","1","18","11","1503","655","2.29","-11","-18","803","18.4","148","1514"
"1143",61,2007,"22","2","24","18","1453","637","2.28","-2","-41","802","20.6","165","1471"
"1144",61,2008,"15","1","22","18","1414","626","2.26","-7","-32","801","21.9","175","1432"
"1145",61,2009,"17","3","19","18","1374","611","2.25","-2","-38","803","23.9","192","1392"
"1146",61,2010,"6","1","19","14","1385","620","2.23","-13","20","806","23.1","186","1399"
"1147",61,2011,"20","6","22","14","1413","631","2.24","-2","30","813","22.4","182","1427"
"1148",61,2012,"8","1","21","14","1391","621","2.24","-13","-9","814","23.7","193","1405"
"1149",61,2013,"15","2","18","14","1374","614","2.24","-3","-14","816","24.8","202","1388"
"1150",61,2014,"19","4","20","14","1363","609","2.24","-1","-10","820","25.7","211","1377"
"1151",61,2015,"14","0","22","14","1368","611","2.24","-8","13","820","25.5","209","1382"
"1152",61,2016,"20","0","21","14","1329","594","2.24","-1","-38","820","27.6","226","1343"
"1153",61,2017,"17","0","21","14","1350","604","2.24","-4","25","821","26.4","217","1364"
"1154",61,2018,"17","0","24","14","1359","608","2.24","-7","16","821","25.9","213","1373"
"1155",61,2019,"10","0","8","14","1381","617","2.24","2","20","821","24.8","204","1395"
"1156",63,1985,"119","2","69","70","7477","2930","2.55","50","-304","3560","17.7","630","7547"
"1157",63,1986,"108","2","75","69","7304","2903","2.52","33","-207","3552","18.3","649","7373"
"1158",63,1987,"118","4","51","68","7173","2890","2.48","67","-199","3545","18.5","655","7241"
"1159",63,1988,"119","4","70","69","7211","2941","2.45","49","-10","3554","17.3","613","7280"
"1160",63,1989,"112","1","74","69","7132","2950","2.42","38","-117","3580","17.6","630","7201"
"1161",63,1990,"110","3","61","66","7062","2785","2.54","49","-122","3224","13.6","439","7128"
"1162",63,1991,"120","3","57","64","7097","2733","2.6","63","-30","3227","15.3","494","7161"
"1163",63,1992,"96","6","64","65","7167","2750","2.61","32","39","3230","14.9","480","7232"
"1164",63,1993,"107","-1","54","66","7201","2812","2.56","53","-18","3236","13.1","424","7267"
"1165",63,1994,"96","20","80","67","7273","2821","2.58","16","57","3235","12.8","414","7340"
"1166",63,1995,"75","20","68","68","7345","2846","2.58","7","66","3255","12.6","409","7413"
"1167",63,1996,"83","18","73","69","7417","2875","2.58","10","63","3275","12.2","400","7486"
"1168",63,1997,"67","15","66","70","7529","2935","2.57","1","112","3293","10.9","358","7599"
"1169",63,1998,"75","32","77","70","7684","2984","2.58","-2","157","3308","9.8","324","7754"
"1170",63,1999,"101","57","71","70","7831","3034","2.58","30","117","3340","9.2","306","7901"
"1171",63,2000,"100","8","85","531","7444","2979","2.5","15","59","3437","13.3","458","7975"
"1172",63,2001,"107","31","69","598","7475","3007","2.49","38","60","3469","13.3","462","8073"
"1173",63,2002,"80","14","85","765","7524","3046","2.47","-5","221","3482","12.6","437","8289"
"1174",63,2003,"78","17","67","788","7397","3009","2.46","11","-115","3497","13.9","487","8185"
"1175",63,2004,"90","5","72","964","7293","2985","2.44","18","54","3503","14.8","518","8257"
"1176",63,2005,"108","6","68","1000","6998","2881","2.43","40","-299","3509","17.9","628","7998"
"1177",63,2006,"98","11","92","1035","6911","2861","2.42","6","-58","3519","18.7","658","7946"
"1178",63,2007,"92","2","80","1024","6811","2836","2.4","12","-123","3520","19.4","684","7835"
"1179",63,2008,"101","6","67","1334","6708","2807","2.39","34","173","3525","20.4","718","8042"
"1180",63,2009,"102","1","76","1508","6761","2846","2.38","26","201","3526","19.3","680","8269"
"1181",63,2010,"108","0","81","1075","7192","3038","2.37","27","-29","3527","13.9","489","8267"
"1182",63,2011,"105","2","83","874","7290","3078","2.37","22","-125","3529","12.8","451","8164"
"1183",63,2012,"93","0","69","808","7259","3065","2.37","24","-121","3529","13.1","464","8067"
"1184",63,2013,"83","0","76","1056","7183","3035","2.37","7","165","3529","14","494","8239"
"1185",63,2014,"94","24","80","782","7227","3053","2.37","14","-244","3552","14","499","8009"
"1186",63,2015,"116","2","75","1009","7196","3041","2.37","41","155","3554","14.4","513","8205"
"1187",63,2016,"94","0","79","490","7149","3020","2.37","15","-581","3554","15","534","7639"
"1188",63,2017,"87","0","72","74","7088","2993","2.37","15","-492","3554","15.8","561","7162"
"1189",63,2018,"79","3","77","74","7091","2995","2.37","2","1","3557","15.8","562","7165"
"1190",63,2019,"98","3","70","74","7054","2981","2.37","28","-65","3559","16.2","578","7128"
"1191",65,1985,"109","8","33","96","6693","2452","2.73","76","-455","3833","36","1381","6789"
"1192",65,1986,"94","7","35","92","6358","2362","2.69","59","-398","3811","38","1449","6450"
"1193",65,1987,"89","10","32","87","5958","2239","2.66","57","-462","3788","40.9","1549","6045"
"1194",65,1988,"82","9","33","83","5667","2153","2.63","49","-344","3803","43.4","1650","5750"
"1195",65,1989,"93","3","31","85","5811","2236","2.6","62","84","3768","40.7","1532","5896"
"1196",65,1990,"90","3","36","24","6011","2382","2.52","54","85","3527","32.5","1145","6035"
"1197",65,1991,"103","8","32","20","6121","2430","2.52","71","35","3530","31.2","1100","6141"
"1198",65,1992,"116","16","31","18","6191","2501","2.48","85","-17","3538","29.3","1037","6209"
"1199",65,1993,"103","9","26","18","6253","2550","2.45","77","-15","3554","28.3","1004","6271"
"1200",65,1994,"78","22","25","38","6342","2595","2.44","53","56","3563","27.2","968","6380"
"1201",65,1995,"100","32","38","33","7110","2768","2.57","62","701","3772","26.6","1004","7143"
"1202",65,1996,"128","43","41","42","7512","3126","2.4","87","324","3804","17.8","678","7554"
"1203",65,1997,"96","58","33","67","7793","3290","2.37","63","243","3847","14.5","557","7860"
"1204",65,1998,"118","44","33","44","7791","3317","2.35","85","-110","3905","15.1","588","7835"
"1205",65,1999,"127","43","46","21","7801","3345","2.33","81","-94","3949","15.3","604","7822"
"1206",65,2000,"145","15","38","99","7841","3032","2.59","107","14","3974","23.7","942","7940"
"1207",65,2001,"136","59","45","99","7722","2989","2.58","91","-210","4014","25.5","1025","7821"
"1208",65,2002,"131","54","38","99","7627","2957","2.58","93","-188","4050","27","1093","7726"
"1209",65,2003,"118","93","36","99","7421","2884","2.57","82","-288","4125","30.1","1241","7520"
"1210",65,2004,"116","60","37","99","7317","2847","2.57","79","-183","4164","31.6","1317","7416"
"1211",65,2005,"115","65","26","99","7185","2799","2.57","89","-221","4210","33.5","1411","7284"
"1212",65,2006,"112","55","28","99","7118","2777","2.56","84","-151","4243","34.6","1466","7217"
"1213",65,2007,"119","52","53","99","7172","2803","2.56","66","-12","4273","34.4","1470","7271"
"1214",65,2008,"128","52","45","99","7170","2806","2.56","83","-85","4304","34.8","1498","7269"
"1215",65,2009,"120","25","37","99","7075","2775","2.55","83","-178","4285","35.2","1510","7174"
"1216",65,2010,"106","0","36","133","7149","2941","2.43","70","38","4271","31.1","1330","7282"
"1217",65,2011,"104","20","41","67","7222","2972","2.43","63","-56","4272","30.4","1300","7289"
"1218",65,2012,"72","18","40","67","7134","2936","2.43","32","-120","4277","31.4","1341","7201"
"1219",65,2013,"80","20","35","67","7150","2942","2.43","45","-29","4277","31.2","1335","7217"
"1220",65,2014,"80","0","43","75","7198","2962","2.43","37","19","4277","30.7","1315","7273"
"1221",65,2015,"86","0","42","91","7308","3008","2.43","44","82","4277","29.7","1269","7399"
"1222",65,2016,"64","39","44","82","7453","3069","2.43","20","116","4294","28.5","1225","7535"
"1223",65,2017,"86","32","38","82","7628","3142","2.43","48","127","4314","27.2","1172","7710"
"1224",65,2018,"84","24","36","82","7705","3175","2.43","48","29","4318","26.5","1143","7787"
"1225",65,2019,"99","51","26","82","7999","3298","2.43","73","221","4338","24","1040","8081"
"1226",67,1985,"550","304","182","1243","30150","11329","2.66","368","-47","14935","24.1","3606","31393"
"1227",67,1986,"460","194","204","1203","29587","11137","2.66","256","-859","15223","26.8","4086","30790"
"1228",67,1987,"486","139","192","1201","29715","11213","2.65","294","-168","15400","27.2","4187","30916"
"1229",67,1988,"456","108","196","1350","29829","11279","2.64","260","3","15565","27.5","4286","31179"
"1230",67,1989,"427","198","198","1400","30409","11562","2.63","229","401","15835","27","4273","31809"
"1231",67,1990,"448","245","190","1666","30800","11976","2.57","258","399","15412","22.3","3436","32466"
"1232",67,1991,"423","264","204","1672","31739","12363","2.57","219","726","15657","21","3294","33411"
"1233",67,1992,"439","392","205","1716","32713","12743","2.57","234","784","15921","20","3178","34429"
"1234",67,1993,"417","467","202","1773","33825","13287","2.55","215","954","16613","20","3326","35598"
"1235",67,1994,"419","590","235","2022","34884","13767","2.53","184","1124","17165","19.8","3398","36906"
"1236",67,1995,"481","643","224","1856","36904","14316","2.58","257","1597","17755","19.4","3439","38760"
"1237",67,1996,"406","514","250","2053","37651","14979","2.51","156","788","19237","22.1","4258","39704"
"1238",67,1997,"469","465","253","2167","38151","15324","2.49","216","398","19768","22.5","4444","40318"
"1239",67,1998,"420","514","232","2141","39032","15716","2.48","188","667","20233","22.3","4517","41173"
"1240",67,1999,"425","401","249","2115","40642","15976","2.54","176","1408","20747","23","4771","42757"
"1241",67,2000,"437","105","241","1825","42753","17602","2.43","196","1625","21117","16.7","3515","44578"
"1242",67,2001,"475","421","218","1828","43817","18067","2.43","257","810","21728","16.9","3661","45645"
"1243",67,2002,"458","537","246","1841","44248","18288","2.42","212","232","22253","17.8","3965","46089"
"1244",67,2003,"479","501","271","1841","44606","18475","2.41","208","150","22632","18.4","4157","46447"
"1245",67,2004,"516","737","269","1831","45095","18728","2.41","247","232","23259","19.5","4531","46926"
"1246",67,2005,"501","732","245","1839","45874","19094","2.4","256","531","23858","20","4764","47713"
"1247",67,2006,"564","873","302","1832","46576","19423","2.4","262","433","24583","21","5160","48408"
"1248",67,2007,"597","690","280","1838","47308","19758","2.39","317","421","25160","21.5","5402","49146"
"1249",67,2008,"606","692","277","1928","48145","20154","2.39","329","598","25719","21.6","5565","50073"
"1250",67,2009,"593","336","275","1910","48849","20488","2.38","318","368","25813","20.6","5325","50759"
"1251",67,2010,"589","58","270","1715","49726","21143","2.35","319","363","25910","18.4","4767","51441"
"1252",67,2011,"543","222","246","1713","50186","21337","2.35","297","161","26119","18.3","4782","51899"
"1253",67,2012,"536","154","332","1876","50622","21520","2.35","204","395","26265","18.1","4745","52498"
"1254",67,2013,"495","172","315","2097","51318","21816","2.35","180","737","26429","17.5","4613","53415"
"1255",67,2014,"552","275","301","1979","51945","22082","2.35","251","258","26686","17.3","4604","53924"
"1256",67,2015,"579","278","345","2026","52732","22422","2.35","234","600","26951","16.8","4529","54758"
"1257",67,2016,"571","336","351","1975","53439","22730","2.35","220","436","27272","16.7","4542","55414"
"1258",67,2017,"503","260","353","1898","53748","22861","2.35","150","82","27535","17","4674","55646"
"1259",67,2018,"459","564","338","1896","54475","23189","2.35","121","604","28116","17.5","4927","56371"
"1260",67,2019,"421","282","345","1898","54374","23147","2.35","76","-175","28482","18.7","5335","56272"
"1261",69,1985,"2785","2619","962","8066","162658","63873","2.55","1823","2437","72762","12.2","8889","170724"
"1262",69,1986,"2784","1937","1085","8337","166643","65821","2.53","1699","2557","75415","12.7","9594","174980"
"1263",69,1987,"2660","1536","1015","8517","169634","67423","2.52","1645","1526","77385","12.9","9962","178151"
"1264",69,1988,"2773","1277","992","8275","171945","68770","2.5","1781","288","78981","12.9","10211","180220"
"1265",69,1989,"2665","1063","1042","8572","175026","70505","2.48","1623","1755","80242","12.1","9737","183598"
"1266",69,1990,"2769","1210","1024","6524","180557","70472","2.56","1745","1738","77811","9.4","7339","187081"
"1267",69,1991,"2699","1517","1090","6799","186743","72906","2.56","1609","4852","79021","7.7","6115","193542"
"1268",69,1992,"2785","1905","1169","7077","192589","75342","2.56","1616","4508","80538","6.5","5196","199666"
"1269",69,1993,"2643","2610","1132","7141","199703","77339","2.58","1511","5667","82443","6.2","5104","206844"
"1270",69,1994,"2793","3170","1144","7387","207549","79859","2.6","1649","6443","85053","6.1","5194","214936"
"1271",69,1995,"2779","2797","1262","7640","213982","82061","2.61","1517","5169","88223","7","6162","221622"
"1272",69,1996,"2821","3491","1246","7998","219250","83997","2.61","1575","4051","91020","7.7","7023","227248"
"1273",69,1997,"2784","2776","1302","8353","224443","86334","2.6","1482","4066","94645","8.8","8311","232796"
"1274",69,1998,"2843","3222","1332","8066","231014","88543","2.61","1511","4773","97421","9.1","8878","239080"
"1275",69,1999,"2993","3591","1432","7779","238377","91039","2.62","1561","5515","100714","9.6","9675","246156"
"1276",69,2000,"3228","866","1431","7120","245968","97905","2.51","1797","5133","106267","7.9","8362","253088"
"1277",69,2001,"3311","3464","1523","7120","253791","101432","2.5","1788","6035","109883","7.7","8451","260911"
"1278",69,2002,"3289","3628","1516","7120","259051","103935","2.49","1773","3487","113808","8.7","9873","266171"
"1279",69,2003,"3358","3052","1531","7120","261026","105158","2.48","1827","148","117039","10.2","11881","268146"
"1280",69,2004,"3500","3030","1551","7770","265499","107379","2.47","1949","3174","120291","10.7","12912","273269"
"1281",69,2005,"3318","3290","1530","7770","268103","108816","2.46","1788","816","123765","12.1","14949","275873"
"1282",69,2006,"3511","2907","1540","7770","273257","111307","2.45","1971","3183","126495","12","15188","281027"
"1283",69,2007,"3517","2221","1532","7787","278967","114060","2.45","1985","3742","128796","11.4","14736","286754"
"1284",69,2008,"3425","1331","1687","7812","284582","116799","2.44","1738","3902","130534","10.5","13735","292394"
"1285",69,2009,"3566","1254","1664","7812","289690","119363","2.43","1902","3206","132197","9.7","12834","297502"
"1286",69,2010,"3378","120","1818","8530","292002","120676","2.42","1560","1470","133124","9.4","12448","300532"
"1287",69,2011,"3313","1207","1861","8376","296974","122711","2.42","1452","3366","134564","8.8","11853","305350"
"1288",69,2012,"3407","1285","1871","8447","302513","124974","2.42","1536","4074","136083","8.2","11109","310960"
"1289",69,2013,"3375","2070","1990","8623","307734","127082","2.42","1385","4012","138231","8.1","11149","316357"
"1290",69,2014,"3490","2592","1986","8938","315211","130097","2.42","1504","6288","140922","7.7","10825","324149"
"1291",69,2015,"3448","2740","2246","9373","324100","133697","2.42","1202","8122","143697","7","10000","333473"
"1292",69,2016,"3463","2659","2182","9323","329859","135999","2.43","1281","4428","146130","6.9","10131","339182"
"1293",69,2017,"3346","3731","2407","9375","334892","137987","2.43","939","4146","149926","8","11939","344267"
"1294",69,2018,"3284","3137","2396","9410","341432","140596","2.43","888","5687","153097","8.2","12501","350842"
"1295",69,2019,"3159","3101","2314","9375","347563","142933","2.43","845","5251","156806","8.8","13873","356938"
"1296",71,1985,"185","22","163","469","13772","5313","2.59","22","-496","6645","20.1","1332","14241"
"1297",71,1986,"183","19","191","462","13651","5312","2.57","-8","-120","6727","21","1415","14113"
"1298",71,1987,"191","21","197","472","13925","5456","2.55","-6","290","6806","19.8","1350","14397"
"1299",71,1988,"183","19","162","385","13837","5459","2.53","21","-196","6833","20.1","1374","14222"
"1300",71,1989,"155","26","161","356","13604","5410","2.51","-6","-256","6838","20.9","1428","13960"
"1301",71,1990,"208","36","182","382","13390","5421","2.47","26","-214","6975","22.3","1554","13772"
"1302",71,1991,"193","55","196","394","13422","5467","2.46","-3","47","7011","22","1544","13816"
"1303",71,1992,"197","38","149","374","13655","5393","2.53","48","165","7066","23.7","1673","14029"
"1304",71,1993,"152","39","157","389","13823","5728","2.41","-5","188","7104","19.4","1376","14212"
"1305",71,1994,"176","59","173","432","14322","5953","2.41","3","539","7143","16.7","1190","14754"
"1306",71,1995,"169","108","210","394","14515","6081","2.39","-41","196","7202","15.6","1121","14909"
"1307",71,1996,"156","83","179","404","14563","6171","2.36","-23","81","7314","15.6","1143","14967"
"1308",71,1997,"146","85","181","409","14636","6286","2.33","-35","113","7397","15","1111","15045"
"1309",71,1998,"163","87","151","377","14677","6345","2.31","12","-3","7482","15.2","1137","15054"
"1310",71,1999,"161","89","183","345","14797","6441","2.3","-22","110","7569","14.9","1128","15142"
"1311",71,2000,"193","20","162","391","14895","6212","2.4","31","117","7647","18.8","1435","15286"
"1312",71,2001,"165","81","209","391","14919","6249","2.39","-44","68","7721","19.1","1472","15310"
"1313",71,2002,"172","76","184","578","15081","6344","2.38","-12","361","7790","18.6","1446","15659"
"1314",71,2003,"168","104","162","870","15219","6432","2.37","6","424","7887","18.5","1455","16089"
"1315",71,2004,"176","72","186","868","14832","6295","2.36","-10","-379","7953","20.9","1658","15700"
"1316",71,2005,"177","45","165","870","14700","6267","2.35","12","-142","7991","21.6","1724","15570"
"1317",71,2006,"189","54","171","873","14679","6287","2.33","18","-36","8037","21.8","1750","15552"
"1318",71,2007,"177","47","152","862","14663","6310","2.32","25","-52","8080","21.9","1770","15525"
"1319",71,2008,"190","60","176","866","14620","6321","2.31","14","-53","8161","22.6","1840","15486"
"1320",71,2009,"193","32","165","862","14615","6348","2.3","28","-37","8204","22.6","1856","15477"
"1321",71,2010,"154","4","176","858","14549","6340","2.29","-22","-48","8221","22.9","1881","15407"
"1322",71,2011,"149","66","196","861","14181","6180","2.29","-47","-318","8285","25.4","2105","15042"
"1323",71,2012,"149","80","163","783","14180","6181","2.29","-14","-65","8362","26.1","2181","14963"
"1324",71,2013,"147","130","185","786","13583","5921","2.29","-38","-556","8488","30.2","2567","14369"
"1325",71,2014,"119","40","159","879","13175","5743","2.29","-40","-275","8526","32.6","2783","14054"
"1326",71,2015,"125","6","181","884","13163","5739","2.29","-56","49","8532","32.7","2793","14047"
"1327",71,2016,"130","3","184","883","13190","5749","2.29","-54","80","8535","32.6","2786","14073"
"1328",71,2017,"145","4","182","882","13327","5846","2.28","-37","173","8542","31.6","2696","14209"
"1329",71,2018,"102","16","161","918","13575","5917","2.29","-59","343","8562","30.9","2645","14493"
"1330",71,2019,"135","40","176","882","13611","5932","2.29","-41","41","8600","31","2668","14493"
"1331",73,1985,"76","6","51","107","4481","1872","2.39","25","92","2296","18.5","424","4588"
"1332",73,1986,"80","2","47","103","4328","1829","2.37","33","-190","2265","19.3","436","4431"
"1333",73,1987,"67","1","51","104","4338","1850","2.34","16","-5","2231","17.1","381","4442"
"1334",73,1988,"81","4","62","107","4470","1923","2.32","19","116","2235","14","312","4577"
"1335",73,1989,"56","6","47","108","4441","1933","2.3","9","-37","2397","19.4","464","4549"
"1336",73,1990,"60","-50","53","105","4609","1817","2.54","7","158","2204","17.6","387","4714"
"1337",73,1991,"61","40","65","585","4845","1892","2.56","-4","720","2226","15","334","5430"
"1338",73,1992,"51","1","60","1035","4940","1930","2.56","-9","554","2266","14.8","336","5975"
"1339",73,1993,"56","23","58","1074","4804","2051","2.34","-2","-95","2267","9.5","216","5878"
"1340",73,1994,"59","1","52","1085","4854","2087","2.33","7","54","2290","8.9","203","5939"
"1341",73,1995,"54","6","60","991","4992","2169","2.3","-6","50","2291","5.3","122","5983"
"1342",73,1996,"61","16","67","1973","4139","1884","2.2","-6","135","2297","18","413","6112"
"1343",73,1997,"56","16","60","1074","5020","2260","2.22","-4","-14","2313","2.3","53","6094"
"1344",73,1998,"61","18","55","1068","5039","2280","2.21","6","7","2329","2.1","49","6107"
"1345",73,1999,"52","13","65","1062","5034","2299","2.19","-13","2","2347","2.1","48","6096"
"1346",73,2000,"54","3","50","1056","5107","2101","2.43","4","71","2403","12.6","302","6163"
"1347",73,2001,"52","13","61","1044","5032","2079","2.42","-9","-78","2412","13.8","333","6076"
"1348",73,2002,"59","7","63","1046","5001","2074","2.41","-4","-25","2413","14.1","339","6047"
"1349",73,2003,"62","8","60","1046","5006","2085","2.4","2","3","2416","13.7","331","6052"
"1350",73,2004,"63","5","46","1059","4848","2027","2.39","17","-162","2416","16.1","389","5907"
"1351",73,2005,"46","5","49","1072","4715","1980","2.38","-3","-117","2416","18.1","436","5787"
"1352",73,2006,"80","6","51","1077","4588","1933","2.37","29","-151","2416","20","483","5665"
"1353",73,2007,"61","9","56","1073","4498","1902","2.36","5","-99","2420","21.4","518","5571"
"1354",73,2008,"51","2","55","1075","4447","1888","2.36","-4","-45","2417","21.9","529","5522"
"1355",73,2009,"61","1","50","1088","4375","1865","2.35","11","-70","2420","22.9","555","5463"
"1356",73,2010,"57","2","48","1030","4444","1950","2.28","9","2","2422","19.5","472","5474"
"1357",73,2011,"64","1","52","971","4417","1940","2.28","12","-98","2423","19.9","483","5388"
"1358",73,2012,"50","4","56","1027","4415","1940","2.28","-6","60","2426","20","486","5442"
"1359",73,2013,"72","9","41","1014","4411","1936","2.28","31","-48","2437","20.6","501","5425"
"1360",73,2014,"49","8","47","1032","4479","1965","2.28","2","84","2444","19.6","479","5511"
"1361",73,2015,"69","2","66","1022","4526","1986","2.28","3","34","2446","18.8","460","5548"
"1362",73,2016,"52","15","59","959","4593","2015","2.28","-7","11","2461","18.1","446","5552"
"1363",73,2017,"53","10","53","953","4573","2007","2.28","0","-26","2470","18.7","463","5526"
"1364",73,2018,"59","11","56","1001","4590","2015","2.28","3","62","2511","19.8","496","5591"
"1365",73,2019,"67","18","55","953","4739","2079","2.28","12","89","2528","17.8","449","5692"
"1366",75,1985,"288","12","163","624","18439","7377","2.5","125","-455","8381","12","1004","19063"
"1367",75,1986,"264","8","154","598","17569","7144","2.46","110","-1006","8389","14.8","1245","18167"
"1368",75,1987,"257","2","170","590","17150","7072","2.43","87","-514","8393","15.7","1321","17740"
"1369",75,1988,"232","-7","181","500","17432","7292","2.39","51","141","8404","13.2","1112","17932"
"1370",75,1989,"243","13","162","437","17288","7342","2.35","81","-288","8340","12","998","17725"
"1371",75,1990,"235","4","197","387","17100","6978","2.45","38","-276","7824","10.8","846","17487"
"1372",75,1991,"234","10","179","379","17124","7143","2.4","55","-39","7828","8.8","685","17503"
"1373",75,1992,"242","5","186","361","17201","7218","2.38","56","3","7838","7.9","620","17562"
"1374",75,1993,"262","8","162","418","17541","6928","2.53","100","297","7843","11.7","915","17959"
"1375",75,1994,"238","36","136","421","18407","7194","2.56","102","767","7851","8.4","657","18828"
"1376",75,1995,"244","85","177","470","18898","7319","2.58","67","473","7887","7.2","568","19368"
"1377",75,1996,"244","101","174","538","19123","7366","2.6","70","223","7972","7.6","606","19661"
"1378",75,1997,"236","108","195","619","19389","7458","2.6","41","306","8073","7.6","615","20008"
"1379",75,1998,"258","137","178","678","19325","7366","2.62","80","-85","8181","10","815","20003"
"1380",75,1999,"256","55","183","737","19552","7389","2.65","73","213","8318","11.2","929","20289"
"1381",75,2000,"246","18","194","1988","18667","7621","2.45","52","309","8473","10.1","852","20655"
"1382",75,2001,"270","71","206","2322","20032","8218","2.44","64","1635","8531","3.7","313","22354"
"1383",75,2002,"250","61","204","2263","19832","8173","2.43","46","-305","8608","5.1","435","22095"
"1384",75,2003,"298","37","193","2369","20002","8273","2.42","105","171","8723","5.2","450","22371"
"1385",75,2004,"239","53","210","2324","19857","8252","2.41","29","-219","8805","6.3","553","22181"
"1386",75,2005,"223","45","202","2336","19752","8251","2.39","21","-114","8854","6.8","603","22088"
"1387",75,2006,"230","54","199","2329","19938","8369","2.38","31","148","8878","5.7","509","22267"
"1388",75,2007,"244","40","180","2454","19949","8416","2.37","64","72","8919","5.6","503","22403"
"1389",75,2008,"231","19","207","2419","19905","8442","2.36","24","-103","8962","5.8","520","22324"
"1390",75,2009,"253","11","194","2455","20062","8552","2.35","59","134","8990","4.9","438","22517"
"1391",75,2010,"206","4","202","3474","18819","8052","2.34","4","-228","8985","10.4","933","22293"
"1392",75,2011,"212","15","182","3418","18696","8000","2.34","30","-209","9000","11.1","1000","22114"
"1393",75,2012,"223","13","182","3253","18645","7978","2.34","41","-257","9013","11.5","1035","21898"
"1394",75,2013,"252","10","199","3196","18511","7920","2.34","53","-244","9023","12.2","1103","21707"
"1395",75,2014,"240","21","239","3366","18617","7965","2.34","1","275","9044","11.9","1079","21983"
"1396",75,2015,"219","20","185","3326","18690","7994","2.34","34","-1","9064","11.8","1070","22016"
"1397",75,2016,"223","27","257","3375","18588","7949","2.34","-34","-19","9090","12.6","1141","21963"
"1398",75,2017,"237","14","228","3365","18499","7912","2.34","9","-108","9104","13.1","1192","21864"
"1399",75,2018,"235","11","196","3400","18416","7875","2.34","39","-87","9118","13.6","1243","21816"
"1400",75,2019,"207","20","215","3365","18549","7934","2.34","-8","106","9147","13.3","1213","21914"
"1401",77,1985,"1423","147","682","2112","85909","33295","2.58","741","-6237","40995","18.8","7700","88021"
"1402",77,1986,"1343","62","717","2057","83505","32661","2.56","626","-3085","41667","21.6","9006","85562"
"1403",77,1987,"1176","97","751","2062","83497","32895","2.54","425","-428","42254","22.2","9359","85559"
"1404",77,1988,"1209","169","848","1971","85317","33859","2.52","361","1368","42417","20.2","8558","87288"
"1405",77,1989,"1246","228","819","2163","88430","35433","2.5","427","2878","40772","13.1","5339","90593"
"1406",77,1990,"1281","267","818","2348","91229","36250","2.52","463","2521","39208","7.5","2958","93577"
"1407",77,1991,"1273","343","858","2359","93633","37531","2.49","415","2000","39475","4.9","1944","95992"
"1408",77,1992,"1292","563","846","2415","94996","38392","2.47","446","973","39818","3.6","1426","97411"
"1409",77,1993,"1344","791","864","2523","97380","39151","2.49","480","2012","40381","3.1","1230","99903"
"1410",77,1994,"1292","924","962","2505","100262","39552","2.53","330","2534","41172","3.9","1620","102767"
"1411",77,1995,"1304","941","920","2761","102645","40691","2.52","384","2255","42096","3.3","1405","105406"
"1412",77,1996,"1342","1044","1000","2806","104723","41627","2.52","342","1781","43037","3.3","1410","107529"
"1413",77,1997,"1363","1114","1022","2862","106900","42915","2.49","341","1892","44081","2.7","1166","109762"
"1414",77,1998,"1404","1286","1078","2977","109350","43781","2.5","326","2239","45195","3.1","1414","112327"
"1415",77,1999,"1428","1362","1012","2881","111692","44717","2.5","416","1830","50976","12.3","6259","114573"
"1416",77,2000,"1485","320","1109","3296","114355","46384","2.47","376","2705","49075","5.5","2691","117651"
"1417",77,2001,"1507","1279","1184","3296","116568","47289","2.47","323","1890","50299","6","3010","119864"
"1418",77,2002,"1522","1219","1161","3296","118491","48078","2.46","361","1562","51456","6.6","3378","121787"
"1419",77,2003,"1554","1330","1231","3296","120856","49062","2.46","323","2042","52889","7.2","3827","124152"
"1420",77,2004,"1708","1548","1200","3296","123330","50104","2.46","508","1966","54221","7.6","4117","126626"
"1421",77,2005,"1755","1511","1232","3296","125703","51099","2.46","523","1850","56346","9.3","5247","128999"
"1422",77,2006,"1859","1449","1270","3584","129544","52649","2.46","589","3540","58239","9.6","5590","133128"
"1423",77,2007,"1994","1494","1210","3584","133806","54381","2.46","784","3478","60151","9.6","5770","137390"
"1424",77,2008,"2062","1296","1353","3627","137053","55703","2.46","709","2581","61775","9.8","6072","140680"
"1425",77,2009,"2048","753","1292","3903","140892","57258","2.46","756","3359","62440","8.3","5182","144795"
"1426",77,2010,"2021","91","1309","4467","142688","57985","2.46","712","1648","62988","7.9","5003","147155"
"1427",77,2011,"1908","472","1296","4628","143325","58247","2.46","612","186","63446","8.2","5199","147953"
"1428",77,2012,"1818","406","1306","4642","143297","58237","2.46","512","-526","63835","8.8","5598","147939"
"1429",77,2013,"1854","552","1378","4950","142935","58092","2.46","476","-530","64357","9.7","6265","147885"
"1430",77,2014,"1760","503","1382","4631","143160","58185","2.46","378","-472","64836","10.3","6651","147791"
"1431",77,2015,"1826","630","1492","4983","143681","58403","2.46","334","539","65440","10.8","7037","148664"
"1432",77,2016,"1709","476","1477","5150","145171","59013","2.46","232","1425","65901","10.5","6888","150321"
"1433",77,2017,"1656","651","1518","5144","146821","59696","2.46","138","1506","66520","10.3","6824","151965"
"1434",77,2018,"1657","811","1527","5140","148582","60433","2.46","130","1627","67293","10.2","6860","153722"
"1435",77,2019,"1604","830","1543","5144","149789","60926","2.46","61","1150","68186","10.6","7260","154933"
"1436",79,1985,"16","10","4","0","836","323","2.59","12","-40","887","63.6","564","836"
"1437",79,1986,"12","12","5","0","771","298","2.59","7","-72","877","66","579","771"
"1438",79,1987,"14","7","0","0","738","285","2.59","13","-47","868","67.2","583","738"
"1439",79,1988,"7","3","6","0","689","265","2.6","1","-50","876","69.8","611","689"
"1440",79,1989,"9","9","4","0","611","235","2.6","5","-83","923","74.5","688","611"
"1441",79,1990,"5","10","6","0","558","247","2.26","-1","-52","1201","79.4","954","558"
"1442",79,1991,"6","11","8","0","570","238","2.39","-2","14","1211","80.4","973","570"
"1443",79,1992,"8","15","0","0","590","240","2.46","8","12","1222","80.4","982","590"
"1444",79,1993,"8","16","4","0","600","253","2.37","4","6","1237","79.6","984","600"
"1445",79,1994,"8","16","8","0","646","269","2.4","0","46","1253","78.5","984","646"
"1446",79,1995,"7","25","4","0","674","277","2.43","3","25","1269","78.2","992","674"
"1447",79,1996,"8","31","7","0","724","294","2.46","1","49","1294","77.3","1000","724"
"1448",79,1997,"6","12","4","0","744","301","2.47","2","18","1325","77.3","1024","744"
"1449",79,1998,"3","14","6","0","772","308","2.51","-3","31","1337","77","1029","772"
"1450",79,1999,"3","13","3","0","806","317","2.54","0","34","1351","76.5","1034","806"
"1451",79,2000,"5","3","9","1","836","381","2.19","-4","34","1120","66","739","837"
"1452",79,2001,"5","14","5","1","819","376","2.18","0","-17","1126","66.6","750","820"
"1453",79,2002,"5","15","7","1","804","373","2.16","-2","-13","1135","67.1","762","805"
"1454",79,2003,"6","16","4","1","829","387","2.14","2","23","1143","66.1","756","830"
"1455",79,2004,"9","17","5","1","841","398","2.11","4","8","1152","65.5","754","842"
"1456",79,2005,"2","19","5","1","805","383","2.1","-3","-33","1163","67.1","780","806"
"1457",79,2006,"1","24","7","1","788","379","2.08","-6","-11","1178","67.8","799","789"
"1458",79,2007,"5","23","5","1","802","389","2.06","0","14","1192","67.4","803","803"
"1459",79,2008,"2","20","7","1","766","376","2.04","-5","-31","1203","68.7","827","767"
"1460",79,2009,"5","4","5","1","713","353","2.02","0","-53","1202","70.6","849","714"
"1461",79,2010,"9","2","8","0","705","351","2.01","1","-10","1203","70.8","852","705"
"1462",79,2011,"5","5","3","0","712","354","2.01","2","5","1208","70.7","854","712"
"1463",79,2012,"6","9","5","0","720","359","2.01","1","7","1217","70.5","858","720"
"1464",79,2013,"4","8","4","0","733","366","2","0","13","1225","70.1","859","733"
"1465",79,2014,"5","11","4","0","704","351","2.01","1","-30","1236","71.6","885","704"
"1466",79,2015,"6","6","7","0","746","372","2.01","-1","43","1242","70","870","746"
"1467",79,2016,"8","12","6","0","757","378","2","2","9","1254","69.9","876","757"
"1468",79,2017,"7","14","16","0","754","376","2.01","-9","6","1268","70.3","892","754"
"1469",79,2018,"8","19","4","0","774","386","2.01","4","16","1287","70","901","774"
"1470",79,2019,"0","19","4","0","764","381","2.01","-4","-6","1306","70.8","925","764"
"1471",81,1985,"256","3","63","97","13189","4567","2.89","193","-1305","5772","20.9","1205","13286"
"1472",81,1986,"193","0","60","92","12587","4351","2.89","133","-740","5740","24.2","1389","12679"
"1473",81,1987,"184","7","63","85","11801","4065","2.9","121","-914","5706","28.8","1641","11886"
"1474",81,1988,"152","-6","81","83","11671","4005","2.91","71","-203","5727","30.1","1722","11754"
"1475",81,1989,"175","-12","55","82","11444","3921","2.92","120","-348","5498","28.7","1577","11526"
"1476",81,1990,"161","2","56","129","11225","4178","2.69","105","-277","5235","20.2","1057","11354"
"1477",81,1991,"176","2","67","133","11316","4327","2.62","109","-14","5237","17.4","910","11449"
"1478",81,1992,"138","7","85","133","11559","4319","2.68","53","190","5239","17.6","920","11692"
"1479",81,1993,"154","15","70","133","11664","4318","2.7","84","21","5246","17.7","928","11797"
"1480",81,1994,"135","17","53","135","11861","4373","2.71","82","117","5261","16.9","888","11996"
"1481",81,1995,"131","44","100","136","12051","4442","2.71","31","160","5278","15.8","836","12187"
"1482",81,1996,"141","42","66","137","12154","4484","2.71","75","29","5371","16.5","887","12291"
"1483",81,1997,"158","60","90","139","12433","4617","2.69","68","213","5413","14.7","796","12572"
"1484",81,1998,"168","34","71","139","12673","4700","2.7","97","143","5473","14.1","773","12812"
"1485",81,1999,"166","44","73","139","12886","4773","2.7","93","120","5507","13.3","734","13025"
"1486",81,2000,"180","10","97","311","12871","4987","2.58","83","73","5645","11.7","658","13182"
"1487",81,2001,"201","40","100","311","12778","4965","2.57","101","-194","5712","13.1","747","13089"
"1488",81,2002,"209","43","106","311","12823","4996","2.57","103","-58","5760","13.3","764","13134"
"1489",81,2003,"175","59","102","311","12743","4980","2.56","73","-153","5850","14.9","870","13054"
"1490",81,2004,"205","60","85","311","12752","4999","2.55","120","-111","5909","15.4","910","13063"
"1491",81,2005,"172","69","91","311","12654","4976","2.54","81","-179","5978","16.8","1002","12965"
"1492",81,2006,"204","73","91","311","12791","5045","2.54","113","24","6050","16.6","1005","13102"
"1493",81,2007,"215","49","108","311","12959","5126","2.53","107","61","6098","15.9","972","13270"
"1494",81,2008,"224","63","88","311","13135","5212","2.52","136","40","6160","15.4","948","13446"
"1495",81,2009,"224","39","80","311","13233","5269","2.51","144","-46","6181","14.8","912","13544"
"1496",81,2010,"217","5","103","102","13704","5470","2.51","114","148","6202","11.8","732","13806"
"1497",81,2011,"187","7","67","102","13334","5322","2.51","120","-490","6209","14.3","887","13436"
"1498",81,2012,"164","10","120","102","13081","5221","2.51","44","-297","6219","16","998","13183"
"1499",81,2013,"190","11","91","102","13035","5202","2.51","99","-145","6230","16.5","1028","13137"
"1500",81,2014,"176","9","90","102","12846","5126","2.51","86","-275","6239","17.8","1113","12948"
"1501",81,2015,"193","9","98","102","12850","5127","2.51","95","-91","6248","17.9","1121","12952"
"1502",81,2016,"181","7","91","102","13062","5213","2.51","90","122","6255","16.7","1042","13164"
"1503",81,2017,"178","10","103","102","13006","5451","2.39","75","-131","6265","13","814","13108"
"1504",81,2018,"155","18","99","102","13090","5475","2.39","56","28","6287","12.9","812","13192"
"1505",81,2019,"160","7","111","102","13150","5498","2.39","49","11","6312","12.9","814","13252"
"1506",83,1985,"345","18","109","160","19123","6390","2.99","236","-784","7601","15.9","1211","19283"
"1507",83,1986,"310","15","149","154","18681","6209","3.01","161","-609","7740","19.8","1531","18835"
"1508",83,1987,"319","6","144","148","18044","5960","3.03","175","-818","7877","24.3","1917","18192"
"1509",83,1988,"321","12","149","145","17965","5897","3.05","172","-254","7904","25.4","2007","18110"
"1510",83,1989,"316","4","163","146","18286","5973","3.06","153","169","7675","22.2","1702","18432"
"1511",83,1990,"278","9","159","152","18558","6762","2.74","119","159","8050","16","1288","18710"
"1512",83,1991,"259","18","165","150","18910","6711","2.82","94","256","8059","16.7","1348","19060"
"1513",83,1992,"320","23","139","155","19496","6939","2.81","181","410","8077","14.1","1138","19651"
"1514",83,1993,"325","79","164","168","20472","7426","2.76","161","828","8482","12.5","1056","20640"
"1515",83,1994,"302","56","186","172","21221","7652","2.77","116","637","8767","12.7","1115","21393"
"1516",83,1995,"316","57","175","171","21988","7914","2.78","141","625","8856","10.6","942","22159"
"1517",83,1996,"341","70","205","175","22475","8090","2.78","136","355","9125","11.3","1035","22650"
"1518",83,1997,"296","27","192","175","22798","8251","2.76","104","219","9339","11.7","1088","22973"
"1519",83,1998,"295","61","204","175","22942","8290","2.77","91","53","9366","11.5","1076","23117"
"1520",83,1999,"315","23","227","175","23349","8426","2.77","88","319","9427","10.6","1001","23524"
"1521",83,2000,"309","10","234","438","23414","9224","2.54","75","259","10535","12.4","1311","23852"
"1522",83,2001,"305","40","242","438","23435","9283","2.52","63","-42","10687","13.1","1404","23873"
"1523",83,2002,"330","59","278","438","23671","9429","2.51","52","184","10861","13.2","1432","24109"
"1524",83,2003,"309","38","236","438","23940","9590","2.5","73","196","11014","12.9","1424","24378"
"1525",83,2004,"316","26","231","438","24169","9738","2.48","85","144","11162","12.8","1424","24607"
"1526",83,2005,"306","41","260","438","24165","9792","2.47","46","-50","11323","13.5","1531","24603"
"1527",83,2006,"298","59","245","438","24579","10020","2.45","53","361","11507","12.9","1487","25017"
"1528",83,2007,"348","62","236","438","24739","10144","2.44","112","48","11691","13.2","1547","25177"
"1529",83,2008,"324","42","259","438","24762","10214","2.42","65","-42","11861","13.9","1647","25200"
"1530",83,2009,"320","19","256","438","24927","10343","2.41","64","101","11994","13.8","1651","25365"
"1531",83,2010,"317","4","270","237","25295","10540","2.4","47","120","12098","12.9","1558","25532"
"1532",83,2011,"308","11","288","237","25197","10500","2.4","20","-118","12109","13.3","1609","25434"
"1533",83,2012,"294","8","268","237","25202","10503","2.4","26","-21","12117","13.3","1614","25439"
"1534",83,2013,"293","9","252","237","25269","10529","2.4","41","26","12126","13.2","1597","25506"
"1535",83,2014,"325","6","272","237","25239","10518","2.4","53","-83","12132","13.3","1614","25476"
"1536",83,2015,"329","54","241","237","25453","10606","2.4","88","126","12186","13","1580","25690"
"1537",83,2016,"297","32","262","237","25744","10729","2.4","35","256","12218","12.2","1489","25981"
"1538",83,2017,"251","23","281","237","25861","10778","2.4","-30","147","12245","12","1467","26098"
"1539",83,2018,"285","46","267","237","25908","10798","2.4","18","29","12298","12.2","1500","26145"
"1540",83,2019,"240","19","273","237","25923","10804","2.4","-33","48","12389","12.8","1585","26160"
"1541",85,1985,"348","108","238","441","23948","9155","2.62","110","-692","10891","15.9","1736","24389"
"1542",85,1986,"300","83","200","436","23397","9097","2.57","100","-656","11040","17.6","1943","23833"
"1543",85,1987,"276","62","228","443","23379","9235","2.53","48","-59","11163","17.3","1928","23822"
"1544",85,1988,"299","90","222","451","23636","9483","2.49","77","188","11251","15.7","1768","24087"
"1545",85,1989,"286","81","238","460","23821","9721","2.45","48","146","11340","14.3","1619","24281"
"1546",85,1990,"342","104","227","395","24144","9405","2.57","115","143","10353","9.2","948","24539"
"1547",85,1991,"319","127","244","412","24863","9833","2.53","75","661","10457","6","624","25275"
"1548",85,1992,"318","182","254","432","25791","10240","2.52","64","884","10584","3.3","344","26223"
"1549",85,1993,"362","257","254","446","26841","10426","2.57","108","956","10766","3.2","340","27287"
"1550",85,1994,"390","364","250","455","28047","10680","2.63","140","1075","11023","3.1","343","28502"
"1551",85,1995,"423","258","264","491","29179","11115","2.63","159","1009","11387","2.4","272","29670"
"1552",85,1996,"434","224","278","517","29970","11446","2.62","156","661","11645","1.7","199","30487"
"1553",85,1997,"481","213","293","530","30722","11783","2.61","188","577","11869","0.7","86","31252"
"1554",85,1998,"421","292","327","530","31307","11977","2.61","94","491","12082","0.9","105","31837"
"1555",85,1999,"438","320","302","530","32218","12242","2.63","136","775","12393","1.2","151","32748"
"1556",85,2000,"435","75","296","550","33027","13109","2.52","139","688","14292","8.3","1183","33577"
"1557",85,2001,"469","300","314","550","33892","13474","2.52","155","710","14563","7.5","1089","34442"
"1558",85,2002,"500","373","352","550","34376","13699","2.51","148","336","14924","8.2","1225","34926"
"1559",85,2003,"449","295","345","550","35090","14020","2.5","104","610","15407","9","1387","35640"
"1560",85,2004,"469","359","349","550","35581","14247","2.5","120","371","15783","9.7","1536","36131"
"1561",85,2005,"515","486","309","550","36447","14622","2.49","206","660","16217","9.8","1595","36997"
"1562",85,2006,"506","583","362","550","37418","15050","2.49","144","827","16877","10.8","1827","37968"
"1563",85,2007,"504","536","364","550","38581","15550","2.48","140","1023","17478","11","1928","39131"
"1564",85,2008,"563","369","404","550","39402","15908","2.48","159","662","17877","11","1969","39952"
"1565",85,2009,"554","189","368","550","40130","16222","2.47","186","542","18083","10.3","1861","40680"
"1566",85,2010,"487","30","389","542","40646","16451","2.47","98","410","18335","10.3","1884","41188"
"1567",85,2011,"492","62","399","542","40428","16362","2.47","93","-311","18439","11.3","2077","40970"
"1568",85,2012,"402","51","450","542","40115","16236","2.47","-48","-265","18529","12.4","2293","40657"
"1569",85,2013,"455","51","383","542","40017","16196","2.47","72","-170","18618","13","2422","40559"
"1570",85,2014,"481","72","388","542","40057","16211","2.47","93","-53","18708","13.3","2497","40599"
"1571",85,2015,"454","89","459","542","40038","16203","2.47","-5","-14","18825","13.9","2622","40580"
"1572",85,2016,"423","124","431","542","40618","16438","2.47","-8","588","18990","13.4","2552","41160"
"1573",85,2017,"466","114","456","542","41244","16690","2.47","10","616","19181","13","2491","41786"
"1574",85,2018,"449","210","427","542","41723","16880","2.47","22","457","19472","13.3","2592","42265"
"1575",85,2019,"359","386","422","542","42223","17086","2.47","-63","563","19898","14.1","2812","42765"
"1576",87,1985,"430","33","218","367","22064","8353","2.64","212","-594","9588","12.9","1235","22431"
"1577",87,1986,"370","79","223","354","21154","8105","2.61","147","-1070","9622","15.8","1517","21508"
"1578",87,1987,"349","9","230","360","21318","8249","2.58","119","51","9701","15","1452","21678"
"1579",87,1988,"371","8","233","362","21469","8386","2.56","138","15","9722","13.7","1336","21831"
"1580",87,1989,"386","5","202","360","21535","8492","2.54","184","-120","9975","14.9","1483","21895"
"1581",87,1990,"342","9","219","456","21600","8139","2.65","123","38","9230","11.8","1091","22056"
"1582",87,1991,"361","28","202","475","22228","8502","2.61","159","488","9239","8","737","22703"
"1583",87,1992,"392","55","246","495","22987","8812","2.61","146","633","9267","4.9","455","23482"
"1584",87,1993,"401","51","256","498","23743","8702","2.73","145","614","9322","6.7","620","24241"
"1585",87,1994,"448","191","239","518","24570","9139","2.69","209","638","9373","2.5","234","25088"
"1586",87,1995,"421","98","241","525","24837","9251","2.68","180","94","9564","3.3","313","25362"
"1587",87,1996,"451","104","214","542","25500","9516","2.68","237","443","9690","1.8","174","26042"
"1588",87,1997,"512","127","231","552","26095","9755","2.68","281","324","9805","0.5","50","26647"
"1589",87,1998,"465","186","238","552","26110","9765","2.67","227","-212","9932","1.7","167","26662"
"1590",87,1999,"540","108","225","552","26401","9877","2.67","315","-24","10118","2.4","241","26953"
"1591",87,2000,"465","28","232","484","26767","9578","2.79","233","64","10440","8.3","862","27251"
"1592",87,2001,"475","113","276","484","26991","9696","2.78","199","25","10569","8.3","873","27475"
"1593",87,2002,"482","94","251","484","27178","9806","2.77","231","-44","10679","8.2","873","27662"
"1594",87,2003,"494","135","233","484","27371","9915","2.76","261","-68","10825","8.4","910","27855"
"1595",87,2004,"414","122","226","479","27433","9979","2.75","188","-131","10964","9","985","27912"
"1596",87,2005,"439","139","240","580","27367","9998","2.74","199","-164","11117","10.1","1119","27947"
"1597",87,2006,"414","129","246","715","27268","10005","2.73","168","-132","11262","11.2","1257","27983"
"1598",87,2007,"415","82","233","674","27174","10017","2.71","182","-317","11360","11.8","1343","27848"
"1599",87,2008,"421","52","278","705","27041","10011","2.7","143","-245","11430","12.4","1419","27746"
"1600",87,2009,"444","27","192","746","27280","10144","2.69","252","28","11463","11.5","1319","28026"
"1601",87,2010,"447","5","239","564","27632","10307","2.68","208","-38","11494","10.3","1187","28196"
"1602",87,2011,"460","2","277","564","27844","10388","2.68","183","29","11508","9.7","1120","28408"
"1603",87,2012,"423","19","271","564","27638","10310","2.68","152","-358","11532","10.6","1222","28202"
"1604",87,2013,"412","26","229","564","27617","10301","2.68","183","-204","11568","11","1267","28181"
"1605",87,2014,"431","22","237","564","27502","10259","2.68","194","-309","11604","11.6","1345","28066"
"1606",87,2015,"454","32","263","564","27651","10204","2.71","191","-42","11653","12.4","1449","28215"
"1607",87,2016,"427","79","283","564","27588","10291","2.68","144","-207","11673","11.8","1382","28152"
"1608",87,2017,"401","33","277","564","27702","10334","2.68","124","-10","11702","11.7","1368","28266"
"1609",87,2018,"469","90","271","564","28172","10505","2.68","198","272","11789","10.9","1284","28736"
"1610",87,2019,"410","146","265","564","28420","10592","2.68","145","103","11930","11.2","1338","28984"
"1611",89,1985,"348","6","255","517","21243","8064","2.63","93","-172","9181","12.2","1117","21760"
"1612",89,1986,"359","-10","212","514","20943","8042","2.6","147","-450","9256","13.1","1214","21457"
"1613",89,1987,"334","4","238","516","20398","7913","2.58","96","-639","9312","15","1399","20914"
"1614",89,1988,"322","11","237","445","20400","7995","2.55","85","-154","9324","14.3","1329","20845"
"1615",89,1989,"322","-2","218","454","20014","7932","2.52","104","-481","9322","14.9","1390","20468"
"1616",89,1990,"296","2","230","493","19717","7593","2.6","66","-324","8739","13.1","1146","20210"
"1617",89,1991,"287","9","223","502","19871","7523","2.64","64","99","8741","13.9","1218","20373"
"1618",89,1992,"318","18","250","546","19748","7820","2.53","68","-147","8750","10.6","930","20294"
"1619",89,1993,"346","3","238","543","19892","7768","2.56","108","33","8768","11.4","1000","20435"
"1620",89,1994,"299","4","248","535","19955","7816","2.55","51","4","8771","10.9","955","20490"
"1621",89,1995,"300","51","260","549","20146","7934","2.54","40","165","8775","9.6","841","20695"
"1622",89,1996,"271","29","252","611","20136","7984","2.52","19","33","8826","9.5","842","20747"
"1623",89,1997,"292","40","260","688","20079","8061","2.49","32","-12","8855","9","794","20767"
"1624",89,1998,"258","32","235","717","19799","7988","2.48","23","-274","8895","10.2","907","20516"
"1625",89,1999,"288","29","214","746","19653","7965","2.47","74","-191","8927","10.8","962","20399"
"1626",89,2000,"281","10","228","568","19675","7901","2.49","53","-218","8821","10.4","920","20243"
"1627",89,2001,"298","41","217","568","19332","7798","2.48","81","-424","8852","11.9","1054","19900"
"1628",89,2002,"322","35","247","568","19056","7723","2.47","75","-351","8875","13","1152","19624"
"1629",89,2003,"296","21","227","568","19099","7776","2.46","69","-26","8886","12.5","1110","19667"
"1630",89,2004,"291","44","216","568","18993","7768","2.45","75","-181","8920","12.9","1152","19561"
"1631",89,2005,"300","21","245","568","18802","7724","2.43","55","-246","8931","13.5","1207","19370"
"1632",89,2006,"232","13","223","568","18625","7688","2.42","9","-186","8933","13.9","1245","19193"
"1633",89,2007,"255","21","216","568","18369","7617","2.41","39","-295","8945","14.9","1328","18937"
"1634",89,2008,"280","37","265","568","18285","7619","2.4","15","-99","8971","15.1","1352","18853"
"1635",89,2009,"230","6","229","568","18276","7650","2.39","1","-10","8973","14.7","1323","18844"
"1636",89,2010,"218","1","213","433","18405","7732","2.38","5","-11","8970","13.8","1238","18838"
"1637",89,2011,"245","3","216","433","18386","7725","2.38","29","-48","8971","13.9","1246","18819"
"1638",89,2012,"270","3","258","433","18190","7638","2.38","12","-208","8974","14.9","1336","18623"
"1639",89,2013,"188","4","220","433","18012","7568","2.38","-32","-146","8977","15.7","1409","18445"
"1640",89,2014,"216","6","262","433","17895","7517","2.38","-46","-71","8981","16.3","1464","18328"
"1641",89,2015,"193","2","240","433","17749","7454","2.38","-47","-99","8972","16.9","1518","18182"
"1642",89,2016,"228","4","251","433","17770","7464","2.38","-23","44","8976","16.8","1512","18203"
"1643",89,2017,"215","3","219","523","17844","7482","2.38","-4","168","8983","16.5","1501","18367"
"1644",89,2018,"228","4","234","499","17878","7508","2.38","-6","16","8984","16.4","1476","18377"
"1645",89,2019,"199","6","254","523","17758","7459","2.38","-55","-41","8988","17","1529","18281"
"1646",91,1985,"33","13","10","0","2130","776","2.74","23","-89","1496","48.1","720","2130"
"1647",91,1986,"20","29","16","0","1999","724","2.76","4","-135","1508","52","784","1999"
"1648",91,1987,"24","27","16","0","2151","776","2.77","8","144","1536","49.5","760","2151"
"1649",91,1988,"26","29","18","0","2219","777","2.86","8","60","1565","50.4","788","2219"
"1650",91,1989,"22","32","10","0","2262","810","2.79","12","31","1613","49.8","803","2262"
"1651",91,1990,"23","32","15","3","2312","947","2.44","8","45","1507","37.2","560","2315"
"1652",91,1991,"31","37","14","3","2416","1014","2.38","17","87","1539","34.1","525","2419"
"1653",91,1992,"29","66","25","3","2532","1101","2.3","4","112","1576","30.1","475","2535"
"1654",91,1993,"21","70","16","3","2650","1082","2.45","5","113","1642","34.1","560","2653"
"1655",91,1994,"27","90","11","4","2898","1174","2.47","16","233","1712","31.4","538","2902"
"1656",91,1995,"30","96","19","4","3081","1247","2.47","11","172","1802","30.8","555","3085"
"1657",91,1996,"25","108","17","4","3248","1316","2.47","8","159","1898","30.7","582","3252"
"1658",91,1997,"31","58","17","4","3318","1348","2.46","14","56","2006","32.8","658","3322"
"1659",91,1998,"35","67","17","4","3449","1397","2.47","18","113","2064","32.3","667","3453"
"1660",91,1999,"38","68","24","4","3614","1461","2.47","14","151","2131","31.4","670","3618"
"1661",91,2000,"26","16","20","18","3757","1592","2.36","6","142","2162","26.4","570","3775"
"1662",91,2001,"40","64","25","18","3791","1618","2.34","15","19","2233","27.5","615","3809"
"1663",91,2002,"31","88","15","18","3885","1672","2.32","16","78","2328","28.2","656","3903"
"1664",91,2003,"31","83","26","18","3887","1685","2.31","5","-3","2431","30.7","746","3905"
"1665",91,2004,"35","107","26","18","4005","1748","2.29","9","109","2566","31.9","818","4023"
"1666",91,2005,"35","100","23","18","4066","1788","2.27","12","49","2688","33.5","900","4084"
"1667",91,2006,"38","88","26","18","4119","1823","2.26","12","41","2852","36.1","1029","4137"
"1668",91,2007,"40","65","29","18","4256","1898","2.24","11","126","2958","35.8","1060","4274"
"1669",91,2008,"42","61","21","18","4389","1973","2.22","21","112","3036","35","1063","4407"
"1670",91,2009,"26","35","21","18","4354","1973","2.21","5","-40","3066","35.7","1093","4372"
"1671",91,2010,"38","5","27","0","4446","2026","2.19","11","63","3088","34.4","1062","4446"
"1672",91,2011,"29","23","19","0","4414","2012","2.19","10","-42","3110","35.3","1098","4414"
"1673",91,2012,"33","21","20","0","4497","2051","2.19","13","70","3130","34.5","1079","4497"
"1674",91,2013,"32","24","33","0","4543","2072","2.19","-1","47","3152","34.3","1080","4543"
"1675",91,2014,"34","28","44","0","4565","2082","2.19","-10","32","3179","34.5","1097","4565"
"1676",91,2015,"21","34","29","0","4597","2096","2.19","-8","40","3210","34.7","1114","4597"
"1677",91,2016,"34","36","34","0","4778","2178","2.19","0","181","3243","32.8","1065","4778"
"1678",91,2017,"31","51","22","0","4799","2188","2.19","9","12","3292","33.5","1104","4799"
"1679",91,2018,"23","42","35","0","4808","2267","2.12","-12","21","3348","32.3","1081","4808"
"1680",91,2019,"17","61","36","0","4934","2323","2.12","-19","145","3408","31.8","1085","4934"
"1681",93,1985,"101","228","31","14","6587","2178","3.02","70","-229","6600","67","4422","6601"
"1682",93,1986,"122","183","25","15","6845","2245","3.05","97","162","6826","67.1","4581","6860"
"1683",93,1987,"95","131","41","14","6923","2248","3.08","54","23","7007","67.9","4759","6937"
"1684",93,1988,"101","122","35","14","6879","2213","3.11","66","-110","7145","69","4932","6893"
"1685",93,1989,"90","109","28","14","7040","2251","3.13","62","99","7163","68.6","4912","7054"
"1686",93,1990,"92","124","27","0","7269","2775","2.62","65","150","7247","61.7","4472","7269"
"1687",93,1991,"108","97","26","0","7700","2895","2.66","82","349","7371","60.7","4476","7700"
"1688",93,1992,"83","182","35","0","8092","3078","2.63","48","344","7468","58.8","4390","8092"
"1689",93,1993,"114","298","34","0","8581","3341","2.57","80","409","7650","56.3","4309","8581"
"1690",93,1994,"105","426","37","0","9526","3694","2.58","68","877","7948","53.5","4254","9526"
"1691",93,1995,"146","452","38","0","10577","4114","2.57","108","943","8374","50.9","4260","10577"
"1692",93,1996,"135","468","42","0","11377","4448","2.56","93","707","8826","49.6","4378","11377"
"1693",93,1997,"130","446","40","0","12362","4880","2.53","90","895","9294","47.5","4414","12362"
"1694",93,1998,"147","345","51","0","13065","5168","2.53","96","607","9740","46.9","4572","13065"
"1695",93,1999,"178","388","43","0","13900","5513","2.52","135","700","10085","45.3","4572","13900"
"1696",93,2000,"149","105","65","70","14659","5992","2.45","84","741","10810","44.6","4818","14729"
"1697",93,2001,"168","422","55","70","15102","6223","2.43","113","330","11265","44.8","5042","15172"
"1698",93,2002,"170","380","70","70","15347","6382","2.4","100","145","11679","45.4","5297","15417"
"1699",93,2003,"173","338","67","70","15719","6595","2.38","106","266","12054","45.3","5459","15789"
"1700",93,2004,"149","292","72","70","15843","6704","2.36","77","47","12384","45.9","5680","15913"
"1701",93,2005,"166","313","58","70","15991","6824","2.34","108","40","12739","46.4","5915","16061"
"1702",93,2006,"161","281","65","70","16058","6915","2.32","96","-29","13063","47.1","6148","16128"
"1703",93,2007,"150","306","71","70","16266","7065","2.3","79","129","13412","47.3","6347","16336"
"1704",93,2008,"135","227","71","70","16208","7104","2.28","64","-122","13684","48.1","6580","16278"
"1705",93,2009,"149","154","64","70","15901","7033","2.26","85","-392","13833","49.2","6800","15971"
"1706",93,2010,"121","26","82","92","16170","7200","2.25","39","252","13948","48.4","6748","16262"
"1707",93,2011,"117","95","82","92","15950","7101","2.25","35","-255","13953","49.1","6852","16042"
"1708",93,2012,"109","73","77","92","15943","7099","2.25","32","-39","13956","49.1","6857","16035"
"1709",93,2013,"97","32","73","92","16081","7160","2.25","24","114","13959","48.7","6799","16173"
"1710",93,2014,"96","57","85","92","16277","7248","2.25","11","185","13961","48.1","6713","16369"
"1711",93,2015,"115","89","90","92","16622","7400","2.25","25","320","13962","47","6562","16714"
"1712",93,2016,"118","122","98","92","17246","7678","2.25","20","604","13963","45","6285","17338"
"1713",93,2017,"113","137","101","92","17790","7920","2.25","12","532","13964","43.3","6044","17882"
"1714",93,2018,"124","154","99","92","18433","8207","2.25","25","618","13970","41.3","5763","18525"
"1715",93,2019,"135","182","118","92","18752","8349","2.25","17","302","14140","41","5791","18844"
"1716",95,1985,"61","3","60","59","4362","1794","2.43","1","-10","2118","15.3","324","4421"
"1717",95,1986,"73","6","47","59","4386","1828","2.4","26","-2","2131","14.2","303","4445"
"1718",95,1987,"45","4","56","59","4352","1834","2.37","-11","-23","2147","14.6","313","4411"
"1719",95,1988,"54","0","37","59","4273","1821","2.35","17","-96","2153","15.4","332","4332"
"1720",95,1989,"52","5","51","90","4159","1799","2.31","1","-84","2114","14.9","315","4249"
"1721",95,1990,"59","6","53","65","4123","1712","2.41","6","-67","1960","12.7","248","4188"
"1722",95,1991,"56","2","57","67","4142","1789","2.32","-1","22","1966","9","177","4209"
"1723",95,1992,"46","7","55","69","4162","1830","2.27","-9","31","1968","7","138","4231"
"1724",95,1993,"55","7","56","68","4310","1798","2.4","-1","148","1975","9","177","4378"
"1725",95,1994,"48","6","76","69","4332","1806","2.4","-28","51","1982","8.9","176","4401"
"1726",95,1995,"52","8","37","70","4409","1841","2.39","15","63","1988","7.4","147","4479"
"1727",95,1996,"70","15","52","70","4434","1863","2.38","18","7","1996","6.7","133","4504"
"1728",95,1997,"51","19","55","71","4503","1910","2.36","-4","74","2011","5","101","4574"
"1729",95,1998,"61","14","64","71","4499","1912","2.35","-3","-1","2030","5.8","118","4570"
"1730",95,1999,"58","20","46","71","4447","1895","2.35","12","-64","2044","7.3","149","4518"
"1731",95,2000,"64","2","50","89","4363","1771","2.46","14","-81","2016","12.2","245","4452"
"1732",95,2001,"52","9","55","89","4398","1790","2.46","-3","38","2023","11.5","233","4487"
"1733",95,2002,"58","13","56","89","4407","1797","2.45","2","7","2035","11.7","238","4496"
"1734",95,2003,"57","9","53","89","4388","1793","2.45","4","-23","2042","12.2","249","4477"
"1735",95,2004,"71","9","63","89","4491","1839","2.44","8","95","2049","10.3","210","4580"
"1736",95,2005,"69","13","38","89","4459","1830","2.44","31","-63","2059","11.1","229","4548"
"1737",95,2006,"58","9","51","89","4415","1817","2.43","7","-51","2067","12.1","250","4504"
"1738",95,2007,"72","8","37","89","4395","1812","2.43","35","-55","2073","12.6","261","4484"
"1739",95,2008,"53","6","58","89","4362","1802","2.42","-5","-28","2077","13.2","275","4451"
"1740",95,2009,"47","3","44","89","4365","1808","2.41","3","0","2083","13.2","275","4454"
"1741",95,2010,"59","2","54","60","4405","1828","2.41","5","6","2088","12.5","260","4465"
"1742",95,2011,"51","3","61","60","4338","1801","2.41","-10","-57","2090","13.8","289","4398"
"1743",95,2012,"55","2","50","60","4353","1808","2.41","5","10","2092","13.6","284","4413"
"1744",95,2013,"41","14","49","60","4321","1795","2.41","-8","-24","2101","14.6","306","4381"
"1745",95,2014,"65","6","49","60","4331","1828","2.37","16","-6","2100","13","272","4391"
"1746",95,2015,"57","9","55","60","4268","1818","2.35","2","-65","2108","13.8","290","4328"
"1747",95,2016,"68","9","45","60","4226","1806","2.34","23","-65","2112","14.5","306","4286"
"1748",95,2017,"53","1","51","60","4234","1808","2.34","2","6","2113","14.4","305","4294"
"1749",95,2018,"41","18","55","60","4215","1805","2.34","-14","-5","2129","15.2","324","4275"
"1750",95,2019,"52","11","44","60","4218","1807","2.33","8","-5","2135","15.4","328","4278"
"1751",97,1985,"144","39","27","21","11295","5458","2.07","117","420","9432","42.1","3974","11316"
"1752",97,1986,"181","60","33","23","11945","5900","2.02","148","504","9468","37.7","3568","11968"
"1753",97,1987,"159","99","27","23","12019","6060","1.98","132","-58","9553","36.6","3493","12042"
"1754",97,1988,"153","112","25","23","12069","6240","1.93","128","-78","9657","35.4","3417","12092"
"1755",97,1989,"168","162","21","24","12391","6652","1.86","147","176","9762","31.9","3110","12415"
"1756",97,1990,"132","153","26","120","12571","5877","2.14","106","170","9837","40.3","3960","12691"
"1757",97,1991,"146","65","32","120","12862","5971","2.15","114","177","9990","40.2","4019","12982"
"1758",97,1992,"170","104","23","123","13248","6159","2.15","147","242","10076","38.9","3917","13371"
"1759",97,1993,"128","138","42","130","13931","6439","2.16","86","604","10183","36.8","3744","14061"
"1760",97,1994,"167","192","38","135","14404","6615","2.18","129","349","10321","35.9","3706","14539"
"1761",97,1995,"141","92","32","134","14518","6655","2.18","109","4","10513","36.7","3858","14652"
"1762",97,1996,"144","180","37","132","14421","6599","2.19","107","-206","10605","37.8","4006","14553"
"1763",97,1997,"150","197","39","133","14654","6730","2.18","111","123","10785","37.6","4055","14787"
"1764",97,1998,"136","174","30","133","14648","6702","2.19","106","-112","11165","40","4463","14781"
"1765",97,1999,"145","280","29","133","14700","6702","2.19","116","-64","11339","40.9","4637","14833"
"1766",97,2000,"176","72","43","328","15436","7248","2.13","133","804","11901","39.1","4653","15764"
"1767",97,2001,"165","287","48","328","15856","7446","2.13","117","303","12117","38.6","4671","16184"
"1768",97,2002,"170","120","32","328","15773","7410","2.13","138","-221","12166","39.1","4756","16101"
"1769",97,2003,"166","134","44","328","15947","7492","2.13","122","52","12229","38.7","4737","16275"
"1770",97,2004,"155","113","39","328","15749","7401","2.13","116","-314","12272","39.7","4871","16077"
"1771",97,2005,"172","118","50","328","15808","7432","2.13","122","-63","12356","39.9","4924","16136"
"1772",97,2006,"157","147","35","328","15759","7411","2.13","122","-171","12485","40.6","5074","16087"
"1773",97,2007,"166","211","40","328","15908","7485","2.13","126","23","12653","40.8","5168","16236"
"1774",97,2008,"162","168","43","328","16345","7703","2.12","119","318","12920","40.4","5217","16673"
"1775",97,2009,"171","115","44","328","16725","7889","2.12","127","253","12979","39.2","5090","17053"
"1776",97,2010,"141","7","38","72","17084","8156","2.09","103","0","12960","37.1","4804","17156"
"1777",97,2011,"175","44","53","72","17105","8164","2.1","122","-101","13003","37.2","4839","17177"
"1778",97,2012,"128","41","51","72","17227","8222","2.1","77","45","13044","37","4822","17299"
"1779",97,2013,"124","23","43","72","17395","8302","2.1","81","87","13067","36.5","4765","17467"
"1780",97,2014,"132","112","59","72","17645","8424","2.09","73","177","13176","36.1","4752","17717"
"1781",97,2015,"127","416","52","72","17876","8554","2.09","75","156","13568","37","5014","17948"
"1782",97,2016,"146","454","65","72","17900","8587","2.08","81","-57","14001","38.7","5414","17972"
"1783",97,2017,"163","90","49","72","17900","8583","2.09","114","-114","14078","39","5495","17972"
"1784",97,2018,"119","53","73","72","17875","8571","2.09","46","-71","14118","39.3","5547","17947"
"1785",97,2019,"148","90","59","72","17684","8483","2.08","89","-280","14185","40.2","5702","17756"
"1786",99,1985,"318","21","120","163","14211","5205","2.73","198","-126","6097","14.6","892","14374"
"1787",99,1986,"273","35","126","160","13968","5142","2.72","147","-393","6133","16.2","991","14128"
"1788",99,1987,"245","-4","148","158","13828","5106","2.71","97","-239","6183","17.4","1077","13986"
"1789",99,1988,"243","-3","121","169","14062","5208","2.7","122","123","6188","15.8","980","14231"
"1790",99,1989,"207","-1","115","151","13568","5046","2.69","92","-604","6180","18.4","1134","13719"
"1791",99,1990,"221","-1","115","186","13051","4984","2.62","106","-588","5855","14.9","871","13237"
"1792",99,1991,"219","-2","116","183","12775","4934","2.59","103","-382","5854","15.7","920","12958"
"1793",99,1992,"214","-4","116","155","12950","4914","2.64","98","49","5852","16","938","13105"
"1794",99,1993,"209","0","124","180","13242","4983","2.66","85","232","5848","14.8","865","13422"
"1795",99,1994,"228","7","105","166","13520","5065","2.67","123","141","5848","13.4","783","13686"
"1796",99,1995,"214","5","105","214","13609","5091","2.67","109","28","5855","13.1","764","13823"
"1797",99,1996,"209","14","135","219","13783","5160","2.67","74","105","5866","12","706","14002"
"1798",99,1997,"220","58","104","198","13919","5241","2.66","116","-1","5947","11.9","706","14117"
"1799",99,1998,"208","54","136","211","14013","5267","2.66","72","35","6005","12.3","738","14224"
"1800",99,1999,"212","93","124","224","14148","5306","2.67","88","60","6059","12.4","753","14372"
"1801",99,2000,"240","4","136","300","14153","5306","2.67","104","-23","5980","11.3","674","14453"
"1802",99,2001,"269","17","141","300","13809","5213","2.65","128","-472","5987","12.9","774","14109"
"1803",99,2002,"247","13","146","300","13711","5217","2.63","101","-199","5986","12.9","769","14011"
"1804",99,2003,"242","15","120","300","13522","5181","2.61","122","-311","6000","13.7","819","13822"
"1805",99,2004,"204","8","126","300","13356","5157","2.59","78","-244","5997","14","840","13656"
"1806",99,2005,"233","8","103","300","13210","5137","2.57","130","-276","5994","14.3","857","13510"
"1807",99,2006,"187","11","99","300","12908","5058","2.55","88","-390","5997","15.7","939","13208"
"1808",99,2007,"189","3","131","300","12472","4925","2.53","58","-494","5958","17.3","1033","12772"
"1809",99,2008,"190","10","128","300","12382","4926","2.51","62","-152","5951","17.2","1025","12682"
"1810",99,2009,"191","0","146","300","12276","4924","2.49","45","-151","5948","17.2","1024","12576"
"1811",99,2010,"186","0","123","315","12216","4928","2.48","63","-108","5942","17.1","1014","12531"
"1812",99,2011,"142","2","149","315","12173","4910","2.48","-7","-36","5945","17.4","1035","12488"
"1813",99,2012,"188","6","127","315","12098","4880","2.48","61","-136","5951","18","1071","12413"
"1814",99,2013,"167","4","118","315","11994","4837","2.48","49","-153","5955","18.8","1118","12309"
"1815",99,2014,"145","5","103","315","11739","4734","2.48","42","-297","5960","20.6","1226","12054"
"1816",99,2015,"165","4","127","315","11613","4684","2.48","38","-164","5964","21.5","1280","11928"
"1817",99,2016,"185","6","149","315","11619","4687","2.48","36","-30","5969","21.5","1282","11934"
"1818",99,2017,"160","6","123","315","11677","4709","2.48","37","21","5968","21.1","1259","11992"
"1819",99,2018,"165","3","133","315","11736","4733","2.48","32","27","5959","20.6","1226","12051"
"1820",99,2019,"150","1","130","315","11807","4763","2.48","20","51","5956","20","1193","12122"
"1821",101,1985,"1844","272","1127","2613","119294","46877","2.54","717","-1205","51045","8.2","4168","121907"
"1822",101,1986,"1781","264","1126","2643","119722","47816","2.5","655","-197","51414","7","3598","122365"
"1823",101,1987,"1780","308","1205","2975","119863","48558","2.47","575","-102","51775","6.2","3217","122838"
"1824",101,1988,"1752","274","1192","2149","121588","49946","2.43","560","339","52116","4.2","2170","123737"
"1825",101,1989,"1625","147","1159","2143","121220","50569","2.4","466","-840","52635","3.9","2066","123363"
"1826",101,1990,"1771","167","1220","2915","119963","47057","2.55","551","-1036","50872","7.5","3815","122878"
"1827",101,1991,"1764","160","1242","2982","120504","48190","2.5","522","86","51039","5.6","2849","123486"
"1828",101,1992,"1805","228","1259","2975","121435","48410","2.51","546","378","51199","5.5","2789","124410"
"1829",101,1993,"1780","364","1169","3025","123323","48120","2.56","611","1327","51544","6.6","3424","126348"
"1830",101,1994,"1746","645","1236","3136","125586","48828","2.57","510","1864","51949","6","3121","128722"
"1831",101,1995,"1730","938","1337","3185","127647","49254","2.59","393","1717","52292","5.8","3038","130832"
"1832",101,1996,"1734","1193","1260","3353","129145","49821","2.59","474","1192","53330","6.6","3509","132498"
"1833",101,1997,"1739","1139","1359","3467","131327","50909","2.58","380","1916","54717","7","3808","134794"
"1834",101,1998,"1869","1351","1352","3498","133883","51749","2.59","517","2070","56103","7.8","4354","137381"
"1835",101,1999,"1933","1437","1374","3529","136189","52510","2.59","559","1778","57454","8.6","4944","139718"
"1836",101,2000,"1927","267","1380","4135","137719","54760","2.51","547","1589","59196","7.5","4436","141854"
"1837",101,2001,"2004","1067","1393","4081","139915","55754","2.51","611","1531","60453","7.8","4699","143996"
"1838",101,2002,"1985","1353","1482","4185","142296","56821","2.5","503","1982","61792","8","4971","146481"
"1839",101,2003,"2060","1265","1451","4032","143940","57613","2.5","609","882","63222","8.9","5609","147972"
"1840",101,2004,"1946","1249","1526","3974","144746","58060","2.49","420","328","64483","10","6423","148720"
"1841",101,2005,"1993","1189","1546","3975","145994","58699","2.49","447","802","65740","10.7","7041","149969"
"1842",101,2006,"2014","1135","1412","3930","148134","59689","2.48","602","1493","66899","10.8","7210","152064"
"1843",101,2007,"2143","1237","1509","4202","150557","60810","2.48","634","2061","68087","10.7","7277","154759"
"1844",101,2008,"2167","642","1608","4111","152141","61613","2.47","559","934","68803","10.5","7190","156252"
"1845",101,2009,"2038","399","1558","4142","153182","62213","2.46","480","592","69140","10","6927","157324"
"1846",101,2010,"2070","94","1542","4321","155175","63148","2.46","528","1644","69614","9.3","6466","159496"
"1847",101,2011,"1865","247","1651","3924","155974","63467","2.46","214","188","69854","9.1","6387","159898"
"1848",101,2012,"1878","135","1591","4102","156335","63611","2.46","287","252","69986","9.1","6375","160437"
"1849",101,2013,"1852","284","1622","4067","156660","63745","2.46","230","60","70264","9.3","6519","160727"
"1850",101,2014,"1921","277","1631","4019","157065","63910","2.46","290","67","70528","9.4","6618","161084"
"1851",101,2015,"1874","83","1734","4004","158713","64583","2.46","140","1493","70601","8.5","6018","162717"
"1852",101,2016,"1851","293","1714","4003","160456","65293","2.46","137","1605","70871","7.9","5578","164459"
"1853",101,2017,"1788","177","1785","4121","161841","65852","2.46","3","1500","71036","7.3","5184","165962"
"1854",101,2018,"1824","284","1836","4111","163018","66328","2.46","-12","1179","71300","7","4972","167129"
"1855",101,2019,"1817","479","1878","4121","163989","66722","2.46","-61","1042","71767","7","5045","168110"
"1856",103,1985,"127","0","37","261","6329","2071","3.06","90","-441","3019","31.4","948","6590"
"1857",103,1986,"103","38","30","257","6183","2006","3.08","73","-223","3024","33.7","1018","6440"
"1858",103,1987,"96","9","37","240","6188","1995","3.1","59","-71","3052","34.6","1057","6428"
"1859",103,1988,"92","5","38","253","6046","1927","3.14","54","-183","3066","37.2","1139","6299"
"1860",103,1989,"89","4","30","217","5894","1861","3.17","59","-247","3027","38.5","1166","6111"
"1861",103,1990,"76","8","38","232","5829","2180","2.67","38","-88","2803","22.2","623","6061"
"1862",103,1991,"86","10","32","132","5895","2263","2.6","54","-88","2811","19.5","548","6027"
"1863",103,1992,"70","21","36","172","6008","2310","2.6","34","119","2809","17.8","499","6180"
"1864",103,1993,"73","22","45","253","6006","2373","2.53","28","51","2830","16.2","457","6259"
"1865",103,1994,"65","15","39","226","6088","2437","2.5","26","29","2852","14.6","415","6314"
"1866",103,1995,"72","17","40","242","6161","2512","2.45","32","57","2867","12.4","355","6403"
"1867",103,1996,"66","14","44","203","6138","2552","2.41","22","-84","2884","11.5","332","6341"
"1868",103,1997,"59","16","48","152","6170","2629","2.35","11","-30","2898","9.3","269","6322"
"1869",103,1998,"62","15","45","161","6071","2634","2.3","17","-107","2914","9.6","280","6232"
"1870",103,1999,"78","18","56","170","5921","2617","2.26","22","-163","2929","10.7","312","6091"
"1871",103,2000,"65","4","47","232","5737","2299","2.5","18","-142","2859","19.6","560","5969"
"1872",103,2001,"66","17","57","232","5648","2270","2.49","9","-98","2887","21.4","617","5880"
"1873",103,2002,"67","24","40","232","5704","2299","2.48","27","29","2919","21.2","620","5936"
"1874",103,2003,"75","17","35","232","5623","2274","2.47","40","-121","2952","23","678","5855"
"1875",103,2004,"76","22","47","232","5672","2298","2.47","29","20","3004","23.5","706","5904"
"1876",103,2005,"75","38","58","232","5586","2269","2.46","17","-103","3052","25.7","783","5818"
"1877",103,2006,"93","47","50","232","5749","2342","2.45","43","120","3106","24.6","764","5981"
"1878",103,2007,"100","47","52","232","5861","2392","2.45","48","64","3171","24.6","779","6093"
"1879",103,2008,"109","74","43","232","5928","2428","2.44","66","1","3253","25.4","825","6160"
"1880",103,2009,"90","62","40","232","6085","2500","2.43","50","107","3292","24.1","792","6317"
"1881",103,2010,"101","6","43","235","6382","2626","2.43","58","242","3315","20.8","689","6617"
"1882",103,2011,"106","21","40","190","6545","2694","2.43","66","52","3338","19.3","644","6735"
"1883",103,2012,"73","16","55","253","6506","2678","2.43","18","6","3356","20.2","678","6759"
"1884",103,2013,"81","6","52","256","6444","2652","2.43","29","-88","3357","21","705","6700"
"1885",103,2014,"70","9","58","256","6346","2613","2.43","12","-110","3366","22.4","753","6602"
"1886",103,2015,"83","9","53","256","6228","2563","2.43","30","-148","3369","23.9","806","6484"
"1887",103,2016,"75","11","62","256","6182","2544","2.43","13","-59","3375","24.6","831","6438"
"1888",103,2017,"67","6","45","241","6110","2515","2.43","22","-109","3384","25.7","869","6351"
"1889",103,2018,"82","13","56","272","6061","2494","2.43","26","-44","3395","26.5","901","6333"
"1890",103,2019,"52","19","55","241","6066","2496","2.43","-3","-23","3403","26.7","907","6307"
"1891",105,1985,"240","0","115","279","11267","3959","2.85","125","68","4879","18.9","920","11546"
"1892",105,1986,"219","5","95","288","11618","4104","2.83","124","236","4910","16.4","806","11906"
"1893",105,1987,"193","0","115","284","11474","4071","2.82","78","-226","4949","17.7","878","11758"
"1894",105,1988,"181","36","107","279","11299","4025","2.81","74","-254","4957","18.8","932","11578"
"1895",105,1989,"195","78","98","262","10847","3887","2.79","97","-566","4975","21.9","1088","11109"
"1896",105,1990,"154","-3","98","198","10570","3930","2.69","56","-397","5277","25.5","1347","10768"
"1897",105,1991,"184","29","112","205","10630","4095","2.6","72","-5","5274","22.4","1179","10835"
"1898",105,1992,"170","18","122","201","10739","4284","2.51","48","57","5303","19.2","1019","10940"
"1899",105,1993,"182","30","101","207","11004","4143","2.66","81","190","5321","22.1","1178","11211"
"1900",105,1994,"157","6","109","210","11251","4233","2.66","48","202","5351","20.9","1118","11461"
"1901",105,1995,"154","113","115","215","11483","4327","2.65","39","198","5357","19.2","1030","11698"
"1902",105,1996,"159","132","104","218","11602","4386","2.65","55","67","5470","19.8","1084","11820"
"1903",105,1997,"158","116","131","222","11744","4504","2.61","27","119","5602","19.6","1098","11966"
"1904",105,1998,"167","97","108","222","11901","4568","2.61","59","98","5718","20.1","1150","12123"
"1905",105,1999,"166","94","109","242","12047","4636","2.6","57","109","5815","20.3","1179","12289"
"1906",105,2000,"189","30","113","251","12178","4713","2.58","76","65","6026","21.8","1313","12429"
"1907",105,2001,"178","120","132","251","12155","4725","2.57","46","-69","6117","22.8","1392","12406"
"1908",105,2002,"175","89","134","251","12158","4747","2.56","41","-38","6195","23.4","1448","12409"
"1909",105,2003,"174","86","127","251","12368","4853","2.55","47","163","6265","22.5","1412","12619"
"1910",105,2004,"173","98","130","251","12573","4955","2.54","43","162","6332","21.8","1377","12824"
"1911",105,2005,"184","97","133","251","12445","4928","2.53","51","-179","6439","23.5","1511","12696"
"1912",105,2006,"191","68","119","251","12188","4849","2.51","72","-329","6496","25.4","1647","12439"
"1913",105,2007,"147","60","138","251","11916","4763","2.5","9","-281","6568","27.5","1805","12167"
"1914",105,2008,"157","47","122","251","11854","4765","2.49","35","-97","6614","28","1849","12105"
"1915",105,2009,"159","42","125","251","11744","4742","2.48","34","-144","6635","28.5","1893","11995"
"1916",105,2010,"166","4","125","198","11803","4787","2.47","41","-35","6633","27.8","1846","12001"
"1917",105,2011,"150","30","122","198","11700","4744","2.47","28","-131","6668","28.9","1924","11898"
"1918",105,2012,"130","22","127","198","11648","4723","2.47","3","-55","6694","29.4","1971","11846"
"1919",105,2013,"150","22","129","198","11458","4645","2.47","21","-211","6732","31","2087","11656"
"1920",105,2014,"149","18","113","198","11293","4578","2.47","36","-201","6751","32.2","2173","11491"
"1921",105,2015,"127","19","131","198","11138","4517","2.47","-4","-151","6774","33.3","2257","11336"
"1922",105,2016,"138","21","128","198","11137","4514","2.47","10","-11","6798","33.6","2284","11335"
"1923",105,2017,"118","7","134","198","11084","4495","2.47","-16","-37","6807","34","2312","11282"
"1924",105,2018,"125","36","137","198","11040","4476","2.47","-12","-32","6850","34.7","2374","11238"
"1925",105,2019,"126","20","121","198","11040","4476","2.47","5","-5","6873","34.9","2397","11238"
"1926",107,1985,"222","62","62","126","14070","5596","2.51","160","-216","9111","38.6","3515","14196"
"1927",107,1986,"206","28","55","125","13738","5546","2.48","151","-484","9165","39.5","3619","13863"
"1928",107,1987,"181","96","60","126","13736","5615","2.45","121","-122","9186","38.9","3571","13862"
"1929",107,1988,"199","66","47","126","13639","5647","2.42","152","-249","9292","39.2","3645","13765"
"1930",107,1989,"220","122","53","129","13821","5805","2.38","167","18","9291","37.5","3486","13950"
"1931",107,1990,"198","187","50","165","14007","5483","2.55","148","74","9252","40.7","3769","14172"
"1932",107,1991,"198","130","40","158","14573","5525","2.64","158","401","9439","41.5","3914","14731"
"1933",107,1992,"171","223","62","153","14996","5533","2.71","109","309","9569","42.2","4036","15149"
"1934",107,1993,"196","287","71","188","15736","6069","2.59","125","650","9792","38","3723","15924"
"1935",107,1994,"184","448","59","195","16422","6293","2.61","125","568","10079","37.6","3786","16617"
"1936",107,1995,"169","443","66","210","17044","6495","2.62","103","534","10527","38.3","4032","17254"
"1937",107,1996,"177","346","56","209","17509","6644","2.64","121","343","10970","39.4","4326","17718"
"1938",107,1997,"179","300","70","210","17907","6809","2.63","109","290","11316","39.8","4507","18117"
"1939",107,1998,"179","508","57","263","18343","6886","2.66","122","367","11616","40.7","4730","18606"
"1940",107,1999,"202","480","70","316","18908","7107","2.66","132","486","12130","41.4","5023","19224"
"1941",107,2000,"226","128","51","257","19866","8184","2.43","175","716","12063","32.2","3879","20123"
"1942",107,2001,"204","512","81","257","20179","8327","2.42","123","190","12534","33.6","4207","20436"
"1943",107,2002,"222","275","69","257","20635","8527","2.42","153","303","12939","34.1","4412","20892"
"1944",107,2003,"235","221","67","257","20871","8647","2.41","168","68","13137","34.2","4489","21128"
"1945",107,2004,"229","313","61","257","21036","8739","2.41","168","-3","13443","35","4704","21293"
"1946",107,2005,"239","347","68","257","21196","8831","2.4","171","-11","13856","36.3","5025","21453"
"1947",107,2006,"249","459","91","330","21556","9001","2.39","158","275","14429","37.6","5428","21886"
"1948",107,2007,"258","405","88","337","22078","9240","2.39","170","359","14838","37.7","5598","22415"
"1949",107,2008,"267","568","95","337","22594","9484","2.38","172","344","15517","38.9","6033","22931"
"1950",107,2009,"260","376","88","337","22988","9673","2.38","172","222","16143","40.1","6470","23325"
"1951",107,2010,"247","18","90","335","23104","9863","2.34","157","-43","16321","39.6","6458","23439"
"1952",107,2011,"228","27","88","338","22921","9785","2.34","140","-320","16347","40.1","6562","23259"
"1953",107,2012,"216","21","92","305","22970","9803","2.34","124","-108","16368","40.1","6565","23275"
"1954",107,2013,"202","36","101","337","23267","9931","2.34","101","228","16400","39.4","6469","23604"
"1955",107,2014,"208","59","103","346","23730","10130","2.34","105","367","16455","38.4","6325","24076"
"1956",107,2015,"214","127","101","333","24037","10260","2.34","113","181","16578","38.1","6318","24370"
"1957",107,2016,"246","99","107","343","24368","10400","2.34","139","202","16671","37.6","6271","24711"
"1958",107,2017,"229","163","123","321","24866","10613","2.34","106","370","16830","36.9","6217","25187"
"1959",107,2018,"193","113","120","321","25185","10750","2.34","73","246","16942","36.5","6192","25506"
"1960",107,2019,"208","170","123","321","25331","10813","2.34","85","61","17098","36.8","6285","25652"
"1961",109,1985,"73","2","34","17","4383","1397","3.14","39","-33","2067","32.4","670","4400"
"1962",109,1986,"81","2","41","18","4580","1445","3.17","40","158","2071","30.2","626","4598"
"1963",109,1987,"87","0","31","18","4767","1482","3.22","56","131","2075","28.6","593","4785"
"1964",109,1988,"65","14","27","17","4646","1424","3.26","38","-160","2079","31.5","655","4663"
"1965",109,1989,"75","0","33","16","4623","1400","3.3","42","-66","2284","38.7","884","4639"
"1966",109,1990,"87","0","31","90","4554","1643","2.77","56","-51","2306","28.8","663","4644"
"1967",109,1991,"87","0","41","95","4637","1758","2.64","46","42","2306","23.8","548","4732"
"1968",109,1992,"80","20","35","98","4690","1779","2.64","45","11","2306","22.9","527","4788"
"1969",109,1993,"85","1","31","96","4730","1766","2.68","54","-16","2326","24.1","560","4826"
"1970",109,1994,"79","69","31","100","4842","1817","2.66","48","68","2327","21.9","510","4942"
"1971",109,1995,"62","48","39","110","5160","1958","2.64","23","305","2396","18.3","438","5270"
"1972",109,1996,"85","67","31","117","5308","2025","2.62","54","101","2444","17.1","419","5425"
"1973",109,1997,"80","136","37","122","5370","2082","2.58","43","24","2511","17.1","429","5492"
"1974",109,1998,"86","105","46","122","5436","2130","2.55","40","26","2647","19.5","517","5558"
"1975",109,1999,"84","119","43","122","5643","2174","2.6","41","166","2752","21","578","5765"
"1976",109,2000,"85","33","51","36","5947","2331","2.55","34","177","3118","25.2","787","5983"
"1977",109,2001,"73","130","47","36","6047","2398","2.52","26","74","3244","26.1","846","6083"
"1978",109,2002,"96","103","53","36","6209","2489","2.5","43","119","3342","25.6","854","6245"
"1979",109,2003,"97","75","40","36","6243","2526","2.47","57","-23","3411","26","885","6279"
"1980",109,2004,"84","82","35","36","6204","2527","2.46","49","-88","3493","27.7","966","6240"
"1981",109,2005,"74","103","35","36","6248","2572","2.43","39","5","3590","28.4","1018","6284"
"1982",109,2006,"99","77","38","36","6205","2580","2.41","61","-104","3659","29.5","1079","6241"
"1983",109,2007,"80","72","38","36","6123","2566","2.39","42","-124","3736","31.3","1170","6159"
"1984",109,2008,"59","62","48","36","6140","2599","2.36","11","6","3791","31.4","1192","6176"
"1985",109,2009,"73","42","47","36","6090","2600","2.34","26","-76","3820","31.9","1220","6126"
"1986",109,2010,"65","10","47","18","6126","2652","2.31","18","0","3859","31.3","1207","6144"
"1987",109,2011,"72","35","37","18","6178","2668","2.32","35","17","3894","31.5","1226","6196"
"1988",109,2012,"76","25","29","18","6329","2736","2.31","47","104","3918","30.2","1182","6347"
"1989",109,2013,"73","32","32","18","6237","2699","2.31","41","-133","3949","31.7","1250","6255"
"1990",109,2014,"55","35","46","18","6192","2684","2.31","9","-54","3981","32.6","1297","6210"
"1991",109,2015,"78","32","60","18","6247","2709","2.31","18","37","4012","32.5","1303","6265"
"1992",109,2016,"77","29","49","18","6407","2779","2.31","28","132","4040","31.2","1261","6425"
"1993",109,2017,"66","54","47","18","6628","2877","2.3","19","202","4092","29.7","1215","6646"
"1994",109,2018,"77","93","55","18","6835","2972","2.3","22","185","4187","29","1215","6853"
"1995",109,2019,"44","106","48","18","6806","2965","2.3","-4","-25","4306","31.1","1341","6824"
"1996",111,1985,"24","0","5","0","763","310","2.46","19","-174","529","41.4","219","763"
"1997",111,1986,"10","-1","6","0","754","310","2.43","4","-13","529","41.4","219","754"
"1998",111,1987,"17","2","4","0","811","337","2.41","13","44","528","36.2","191","811"
"1999",111,1988,"10","-1","0","0","747","313","2.39","8","-74","531","41.1","218","747"
"2000",111,1989,"7","-1","4","0","746","318","2.35","3","-4","521","39","203","746"
"2001",111,1990,"16","2","3","0","736","287","2.56","13","-23","481","40.3","194","736"
"2002",111,1991,"14","1","3","0","711","285","2.49","11","-36","483","41","198","711"
"2003",111,1992,"9","4","3","0","574","228","2.52","6","-142","484","52.9","256","574"
"2004",111,1993,"6","7","5","0","540","202","2.67","1","-31","488","58.6","286","540"
"2005",111,1994,"7","2","0","0","563","209","2.69","7","14","495","57.8","286","563"
"2006",111,1995,"10","6","6","0","571","211","2.71","4","4","497","57.6","286","571"
"2007",111,1996,"6","6","4","0","579","215","2.69","2","6","503","57.3","288","579"
"2008",111,1997,"5","10","7","0","570","214","2.66","-2","-9","509","58","295","570"
"2009",111,1998,"5","7","3","0","555","207","2.68","2","-18","519","60.1","312","555"
"2010",111,1999,"8","4","5","0","557","206","2.7","3","-1","606","66","400","557"
"2011",111,2000,"3","1","3","5","556","270","2.06","0","9","633","57.4","363","561"
"2012",111,2001,"5","5","3","5","561","273","2.05","2","3","639","57.3","366","566"
"2013",111,2002,"5","9","1","5","594","290","2.05","4","29","650","55.4","360","599"
"2014",111,2003,"6","14","0","5","610","298","2.05","6","10","664","55.1","366","615"
"2015",111,2004,"6","19","3","5","630","308","2.05","3","17","685","55","377","635"
"2016",111,2005,"6","19","3","5","640","314","2.04","3","7","706","55.5","392","645"
"2017",111,2006,"9","20","2","5","667","327","2.04","7","20","729","55.1","402","672"
"2018",111,2007,"7","11","4","5","681","335","2.03","3","11","741","54.8","406","686"
"2019",111,2008,"5","4","2","5","693","341","2.03","3","9","746","54.3","405","698"
"2020",111,2009,"3","7","3","5","682","335","2.04","0","-11","752","55.5","417","687"
"2021",111,2010,"3","1","3","0","709","349","2.03","0","22","757","53.9","408","709"
"2022",111,2011,"8","1","8","0","691","340","2.03","0","-18","758","55.1","418","691"
"2023",111,2012,"3","1","2","0","694","342","2.03","1","2","759","54.9","417","694"
"2024",111,2013,"1","6","5","0","692","340","2.04","-4","2","765","55.6","425","692"
"2025",111,2014,"7","0","3","0","712","351","2.03","4","16","765","54.1","414","712"
"2026",111,2015,"6","0","6","0","689","339","2.03","0","-23","765","55.7","426","689"
"2027",111,2016,"5","6","3","0","690","339","2.04","2","-1","771","56","432","690"
"2028",111,2017,"6","8","5","0","712","350","2.03","1","21","779","55.1","429","712"
"2029",111,2018,"3","7","1","0","762","375","2.03","2","48","786","52.3","411","762"
"2030",111,2019,"0","7","0","0","726","358","2.03","0","-36","793","54.9","435","726"
"2031",113,1985,"63","156","5","0","3189","1415","2.25","58","172","2103","32.7","688","3189"
"2032",113,1986,"52","78","12","0","3374","1546","2.18","40","145","2265","31.7","719","3374"
"2033",113,1987,"47","43","8","0","3463","1619","2.14","39","50","2350","31.1","731","3463"
"2034",113,1988,"63","56","14","0","3557","1700","2.09","49","45","2395","29","695","3557"
"2035",113,1989,"43","92","8","0","3612","1769","2.04","35","20","2440","27.5","671","3612"
"2036",113,1990,"57","136","11","56","3676","1489","2.47","46","74","2635","43.5","1146","3732"
"2037",113,1991,"53","178","10","57","4073","1546","2.63","43","355","2771","44.2","1225","4130"
"2038",113,1992,"49","169","11","53","4512","1489","3.03","38","397","2949","49.5","1460","4565"
"2039",113,1993,"51","220","19","65","4799","1920","2.5","32","267","3123","38.5","1203","4864"
"2040",113,1994,"48","353","8","78","5227","2076","2.52","40","401","3343","37.9","1267","5305"
"2041",113,1995,"63","113","11","75","5414","2132","2.54","52","132","3696","42.3","1564","5489"
"2042",113,1996,"64","152","15","78","5726","2239","2.56","49","266","3809","41.2","1570","5804"
"2043",113,1997,"53","114","14","79","5874","2294","2.56","39","110","3961","42.1","1667","5953"
"2044",113,1998,"74","178","10","79","6374","2350","2.71","64","436","4075","42.3","1725","6453"
"2045",113,1999,"56","145","10","79","6454","2476","2.61","46","34","4530","45.3","2054","6533"
"2046",113,2000,"67","35","13","17","6598","3027","2.18","54","30","5231","42.1","2204","6615"
"2047",113,2001,"65","138","15","17","6883","3169","2.17","50","235","5392","41.2","2223","6900"
"2048",113,2002,"84","130","13","17","7025","3243","2.17","71","71","5555","41.6","2312","7042"
"2049",113,2003,"74","97","24","17","6993","3234","2.16","50","-82","5690","43.2","2456","7010"
"2050",113,2004,"78","94","15","17","7010","3248","2.16","63","-46","5813","44.1","2565","7027"
"2051",113,2005,"72","126","15","17","7028","3258","2.16","57","-39","5930","45.1","2672","7045"
"2052",113,2006,"105","205","21","17","7042","3273","2.15","84","-70","6157","46.8","2884","7059"
"2053",113,2007,"96","155","19","17","7259","3397","2.14","77","140","6343","46.4","2946","7276"
"2054",113,2008,"118","148","11","17","7287","3416","2.13","107","-79","6521","47.6","3105","7304"
"2055",113,2009,"79","120","13","17","7250","3399","2.13","66","-103","6583","48.4","3184","7267"
"2056",113,2010,"65","11","20","9","7347","3451","2.13","45","44","6659","48.2","3208","7356"
"2057",113,2011,"76","26","18","9","7479","3512","2.13","58","74","6684","47.5","3172","7488"
"2058",113,2012,"72","7","31","9","7571","3556","2.13","41","51","6691","46.9","3135","7580"
"2059",113,2013,"68","12","25","9","7612","3575","2.13","43","-2","6703","46.7","3128","7621"
"2060",113,2014,"69","28","26","9","7729","3630","2.13","43","74","6732","46.1","3102","7738"
"2061",113,2015,"68","84","22","9","7829","3675","2.13","46","54","6814","46.1","3139","7838"
"2062",113,2016,"68","35","27","9","8010","3761","2.13","41","140","6849","45.1","3088","8019"
"2063",113,2017,"68","36","16","9","8027","3769","2.13","52","-35","6884","45.2","3115","8036"
"2064",113,2018,"49","80","13","9","8164","3831","2.13","36","101","6960","45","3129","8173"
"2065",113,2019,"62","53","24","9","8165","3832","2.13","38","-37","7010","45.3","3178","8174"
"2066",115,1985,"30","0","39","50","2941","1240","2.37","-9","-201","1519","18.4","279","2991"
"2067",115,1986,"36","0","27","47","2778","1190","2.33","9","-175","1520","21.7","330","2825"
"2068",115,1987,"31","0","38","47","2746","1195","2.3","-7","-25","1520","21.4","325","2793"
"2069",115,1988,"35","0","30","47","2747","1213","2.26","5","-4","1521","20.3","308","2794"
"2070",115,1989,"28","2","39","47","2687","1206","2.23","-11","-49","1524","20.9","318","2734"
"2071",115,1990,"29","2","22","32","2648","1141","2.32","7","-61","1414","19.3","273","2680"
"2072",115,1991,"30","2","22","31","2639","1115","2.37","8","-18","1416","21.3","301","2670"
"2073",115,1992,"30","1","41","31","2598","1115","2.33","-11","-30","1418","21.4","303","2629"
"2074",115,1993,"19","2","34","31","2618","1122","2.33","-15","35","1419","20.9","297","2649"
"2075",115,1994,"31","1","47","31","2633","1121","2.35","-16","31","1421","21.1","300","2664"
"2076",115,1995,"34","0","42","31","2619","1116","2.35","-8","-6","1422","21.5","306","2650"
"2077",115,1996,"29","2","43","31","2655","1136","2.34","-14","50","1422","20.1","286","2686"
"2078",115,1997,"29","21","38","31","2700","1163","2.32","-9","54","1424","18.3","261","2731"
"2079",115,1998,"35","9","47","31","2650","1142","2.32","-12","-38","1445","21","303","2681"
"2080",115,1999,"35","2","35","31","2688","1158","2.32","0","38","1454","20.4","296","2719"
"2081",115,2000,"30","1","42","57","2687","1166","2.3","-12","38","1389","16.1","223","2744"
"2082",115,2001,"33","4","37","57","2637","1152","2.29","-4","-46","1396","17.5","244","2694"
"2083",115,2002,"30","2","43","57","2637","1161","2.27","-13","13","1401","17.1","240","2694"
"2084",115,2003,"20","0","39","57","2658","1179","2.25","-19","40","1402","15.9","223","2715"
"2085",115,2004,"31","1","44","57","2549","1132","2.25","-13","-96","1389","18.5","257","2606"
"2086",115,2005,"35","2","49","57","2521","1132","2.23","-14","-14","1394","18.8","262","2578"
"2087",115,2006,"21","2","34","57","2458","1113","2.21","-13","-50","1399","20.4","286","2515"
"2088",115,2007,"14","1","34","57","2365","1081","2.19","-20","-73","1403","23","322","2422"
"2089",115,2008,"27","1","33","57","2363","1092","2.16","-6","4","1408","22.4","316","2420"
"2090",115,2009,"21","1","31","57","2319","1080","2.15","-10","-34","1411","23.5","331","2376"
"2091",115,2010,"21","0","36","35","2332","1086","2.15","-15","6","1415","23.3","329","2367"
"2092",115,2011,"29","0","41","35","2333","1088","2.14","-12","13","1415","23.1","327","2368"
"2093",115,2012,"21","0","38","35","2339","1092","2.14","-17","23","1415","22.8","323","2374"
"2094",115,2013,"27","2","29","35","2301","1073","2.14","-2","-36","1417","24.3","344","2336"
"2095",115,2014,"26","3","33","35","2294","1070","2.14","-7","0","1420","24.6","350","2329"
"2096",115,2015,"24","1","53","35","2337","1090","2.14","-29","72","1421","23.3","331","2372"
"2097",115,2016,"29","0","36","35","2363","1101","2.15","-7","33","1421","22.5","320","2398"
"2098",115,2017,"20","3","34","35","2277","1060","2.15","-14","-72","1425","25.6","365","2312"
"2099",115,2018,"21","2","35","35","2231","1039","2.15","-14","-32","1429","27.3","390","2266"
"2100",115,2019,"0","2","28","35","2194","1023","2.14","-28","-9","1431","28.5","408","2229"
"2101",117,1985,"243","115","25","0","12865","5697","2.26","218","633","14623","61","8926","12865"
"2102",117,1986,"236","183","17","0","13274","5978","2.22","219","190","14708","59.4","8730","13274"
"2103",117,1987,"188","94","16","0","12406","5693","2.18","172","-1040","14862","61.7","9169","12406"
"2104",117,1988,"203","113","22","0","12498","5849","2.14","181","-89","14960","60.9","9111","12498"
"2105",117,1989,"196","150","20","0","12718","6090","2.09","176","44","15115","59.7","9025","12718"
"2106",117,1990,"207","244","9","55","12885","5295","2.43","198","24","17091","69","11796","12940"
"2107",117,1991,"209","198","13","55","13416","5448","2.46","196","335","17335","68.6","11887","13471"
"2108",117,1992,"202","298","31","59","13781","5684","2.42","171","198","17533","67.6","11849","13840"
"2109",117,1993,"203","444","38","62","15132","6014","2.52","165","1189","17831","66.3","11817","15194"
"2110",117,1994,"211","862","20","69","17038","6678","2.55","191","1722","18275","63.5","11597","17107"
"2111",117,1995,"200","947","20","71","18199","7055","2.58","180","983","19500","63.8","12445","18270"
"2112",117,1996,"194","1270","36","75","19321","7429","2.6","158","968","20447","63.7","13018","19396"
"2113",117,1997,"241","927","39","77","20272","7777","2.61","202","751","21224","63.4","13447","20349"
"2114",117,1998,"216","1162","30","77","21204","8049","2.63","186","746","22211","63.8","14162","21281"
"2115",117,1999,"281","488","46","77","22491","8397","2.68","235","1052","23807","64.7","15410","22568"
"2116",117,2000,"275","194","38","927","24782","10169","2.44","237","2904","27457","63","17288","25709"
"2117",117,2001,"329","777","44","927","25366","10408","2.44","285","299","28741","63.8","18333","26293"
"2118",117,2002,"364","464","41","927","25587","10505","2.44","323","-102","28911","63.7","18406","26514"
"2119",117,2003,"346","384","32","927","25779","10588","2.43","314","-122","29154","63.7","18566","26706"
"2120",117,2004,"353","397","46","927","25780","10593","2.43","307","-306","29282","63.8","18689","26707"
"2121",117,2005,"339","322","46","927","25696","10568","2.43","293","-377","29379","64","18811","26623"
"2122",117,2006,"367","456","50","927","25912","10660","2.43","317","-101","29419","63.8","18759","26839"
"2123",117,2007,"345","422","42","927","26236","10801","2.43","303","21","29536","63.4","18735","27163"
"2124",117,2008,"366","437","49","927","26537","10928","2.43","317","-16","29646","63.1","18718","27464"
"2125",117,2009,"373","341","47","927","26856","11072","2.43","326","-7","29943","63","18871","27783"
"2126",117,2010,"287","20","51","273","27800","11787","2.36","236","54","29861","60.5","18074","28073"
"2127",117,2011,"308","93","54","273","27771","11776","2.36","254","-283","29952","60.7","18176","28044"
"2128",117,2012,"309","154","57","273","28026","11885","2.36","252","3","30103","60.5","18218","28299"
"2129",117,2013,"248","139","53","273","28457","12069","2.36","195","236","30238","60.1","18169","28730"
"2130",117,2014,"271","276","67","273","29050","12313","2.36","204","389","30509","59.6","18196","29323"
"2131",117,2015,"271","211","69","273","29778","12624","2.36","202","526","30714","58.9","18090","30051"
"2132",117,2016,"295","143","63","273","30293","12840","2.36","232","283","30853","58.4","18013","30566"
"2133",117,2017,"279","306","68","273","30555","12947","2.36","211","51","31152","58.4","18205","30828"
"2134",117,2018,"275","399","71","273","30540","12936","2.36","204","-219","31544","59","18608","30813"
"2135",117,2019,"241","643","71","273","30710","13005","2.36","170","0","32188","59.6","19183","30983"
"2136",119,1985,"202","116","62","52","11253","3920","2.87","140","313","6844","42.7","2924","11305"
"2137",119,1986,"209","242","58","52","11748","4079","2.88","151","344","7014","41.8","2935","11800"
"2138",119,1987,"191","170","57","52","12406","4284","2.9","134","524","7309","41.4","3025","12458"
"2139",119,1988,"179","82","52","50","12427","4267","2.91","127","-108","7488","43","3221","12477"
"2140",119,1989,"190","78","53","49","12425","4248","2.92","137","-140","7503","43.4","3255","12474"
"2141",119,1990,"185","68","61","64","12447","4720","2.64","124","-87","7565","37.6","2845","12511"
"2142",119,1991,"194","74","73","66","12646","4996","2.53","121","80","7633","34.6","2637","12712"
"2143",119,1992,"155","189","65","67","13603","5076","2.68","90","868","7707","34.1","2631","13670"
"2144",119,1993,"143","198","66","77","14658","5680","2.58","77","988","7896","28.1","2216","14735"
"2145",119,1994,"185","249","73","82","15708","6118","2.57","112","943","8094","24.4","1976","15790"
"2146",119,1995,"214","264","78","99","16882","6615","2.55","136","1055","8343","20.7","1728","16981"
"2147",119,1996,"220","533","93","106","18029","7035","2.56","127","1027","8607","18.3","1572","18135"
"2148",119,1997,"236","368","65","128","18938","7498","2.53","171","760","9189","18.4","1691","19066"
"2149",119,1998,"203","301","82","128","19544","7777","2.51","121","485","9557","18.6","1780","19672"
"2150",119,1999,"218","304","73","128","20051","8024","2.5","145","362","9858","18.6","1834","20179"
"2151",119,2000,"214","90","96","120","20948","8207","2.55","118","766","10660","23","2453","21068"
"2152",119,2001,"211","359","83","120","21618","8532","2.53","128","542","11043","22.7","2511","21738"
"2153",119,2002,"249","203","96","120","21869","8694","2.52","153","98","11285","23","2591","21989"
"2154",119,2003,"232","229","93","120","22098","8853","2.5","139","90","11532","23.2","2679","22218"
"2155",119,2004,"219","206","95","120","22098","8918","2.48","124","-124","11778","24.3","2860","22218"
"2156",119,2005,"205","275","104","120","22385","9101","2.46","101","186","12104","24.8","3003","22505"
"2157",119,2006,"206","195","120","120","22671","9292","2.44","86","200","12294","24.4","3002","22791"
"2158",119,2007,"234","160","98","120","23044","9519","2.42","136","237","12450","23.5","2931","23164"
"2159",119,2008,"195","137","121","120","22982","9570","2.4","74","-136","12583","24","3013","23102"
"2160",119,2009,"183","88","124","120","23085","9690","2.38","59","44","12619","23.2","2929","23205"
"2161",119,2010,"202","9","151","132","23309","9844","2.37","51","185","12651","22.2","2807","23441"
"2162",119,2011,"222","37","134","132","23207","9801","2.37","88","-190","12692","22.8","2891","23339"
"2163",119,2012,"154","64","144","132","23281","9832","2.37","10","64","12757","22.9","2925","23413"
"2164",119,2013,"165","75","125","132","23192","9794","2.37","40","-129","12832","23.7","3038","23324"
"2165",119,2014,"195","56","174","132","23270","9828","2.37","21","57","12889","23.7","3061","23402"
"2166",119,2015,"192","157","181","132","23224","9806","2.37","11","-57","13042","24.8","3236","23356"
"2167",119,2016,"191","91","174","132","23895","10089","2.37","17","654","13131","23.2","3042","24027"
"2168",119,2017,"181","132","144","132","24514","10347","2.37","37","582","13260","22","2913","24646"
"2169",119,2018,"170","109","172","132","24962","10175","2.45","-2","450","13371","23.9","3196","25094"
"2170",119,2019,"154","148","190","132","25223","10286","2.45","-36","297","13516","23.9","3230","25355"
"2171",121,1985,"68","3","61","23","5373","2108","2.55","7","-155","2555","17.5","447","5396"
"2172",121,1986,"77","2","52","22","5172","2043","2.53","25","-227","2570","20.5","527","5194"
"2173",121,1987,"75","4","54","22","5165","2050","2.52","21","-28","2584","20.7","534","5187"
"2174",121,1988,"52","1","46","22","5120","2042","2.51","6","-51","2591","21.2","549","5142"
"2175",121,1989,"53","2","42","21","4930","1977","2.49","11","-202","2630","24.8","653","4951"
"2176",121,1990,"58","3","56","34","4770","1915","2.49","2","-149","2307","17","392","4804"
"2177",121,1991,"45","4","69","37","4746","2122","2.24","-24","3","2310","8.1","188","4783"
"2178",121,1992,"63","2","52","38","4848","2143","2.26","11","92","2314","7.4","171","4886"
"2179",121,1993,"56","3","52","37","5107","2073","2.46","4","254","2316","10.5","243","5144"
"2180",121,1994,"60","1","52","37","5184","2107","2.46","8","69","2319","9.1","212","5221"
"2181",121,1995,"70","12","55","38","5198","2125","2.45","15","0","2320","8.4","195","5236"
"2182",121,1996,"49","9","58","38","5183","2136","2.43","-9","-6","2332","8.4","196","5221"
"2183",121,1997,"61","11","52","38","5172","2157","2.4","9","-20","2341","7.9","184","5210"
"2184",121,1998,"45","17","59","38","5117","2145","2.39","-14","-41","2352","8.8","207","5155"
"2185",121,1999,"65","8","62","38","4986","2100","2.37","3","-134","2369","11.4","269","5024"
"2186",121,2000,"46","4","53","39","4897","1995","2.45","-7","-79","2312","13.7","317","4936"
"2187",121,2001,"48","16","43","52","4847","1984","2.44","5","-42","2332","14.9","348","4899"
"2188",121,2002,"40","10","65","161","5098","2097","2.43","-25","385","2345","10.6","248","5259"
"2189",121,2003,"57","15","49","161","4979","2058","2.42","8","-127","2364","12.9","306","5140"
"2190",121,2004,"38","11","57","222","4838","2010","2.41","-19","-61","2379","15.5","369","5060"
"2191",121,2005,"45","4","47","222","4773","1992","2.4","-2","-63","2386","16.5","394","4995"
"2192",121,2006,"45","6","57","222","4759","1998","2.38","-12","-2","2394","16.5","396","4981"
"2193",121,2007,"42","9","38","222","4705","1984","2.37","4","-58","2407","17.6","423","4927"
"2194",121,2008,"43","7","53","222","4580","1941","2.36","-10","-115","2418","19.7","477","4802"
"2195",121,2009,"44","1","44","222","4555","1940","2.35","0","-25","2427","20.1","487","4777"
"2196",121,2010,"54","2","41","344","4471","1912","2.34","13","25","2435","21.5","523","4815"
"2197",121,2011,"40","5","53","184","4411","1886","2.34","-13","-207","2445","22.9","559","4595"
"2198",121,2012,"40","1","50","184","4350","1859","2.34","-10","-51","2453","24.2","594","4534"
"2199",121,2013,"35","1","42","184","4392","1878","2.34","-7","49","2457","23.6","579","4576"
"2200",121,2014,"47","2","51","184","4383","1874","2.34","-4","-5","2463","23.9","589","4567"
"2201",121,2015,"47","5","50","184","4435","1895","2.34","-3","55","2473","23.4","578","4619"
"2202",121,2016,"57","5","66","184","4485","1916","2.34","-9","59","2485","22.9","569","4669"
"2203",121,2017,"45","6","39","184","4572","1954","2.34","6","81","2497","21.7","543","4756"
"2204",121,2018,"58","8","58","184","4537","1938","2.34","0","-35","2507","22.7","569","4721"
"2205",121,2019,"46","9","46","184","4558","1948","2.34","0","21","2526","22.9","578","4742"
"2206",123,1985,"2262","878","830","4514","125886","48812","2.58","1432","-21","50425","3.2","1613","130400"
"2207",123,1986,"2159","668","840","4562","125187","49446","2.53","1319","-1970","51309","3.6","1863","129749"
"2208",123,1987,"2143","413","874","4688","126340","50388","2.51","1269","10","51988","3.1","1600","131028"
"2209",123,1988,"2120","295","806","4406","127474","51212","2.49","1314","-462","52466","2.4","1254","131880"
"2210",123,1989,"2164","253","841","4526","127341","51760","2.46","1323","-1336","52759","1.9","999","131867"
"2211",123,1990,"2202","262","843","4160","127786","47470","2.69","1359","-1280","51138","7.2","3668","131946"
"2212",123,1991,"2270","355","834","4301","131430","48760","2.7","1436","2349","51400","5.1","2640","135731"
"2213",123,1992,"2298","506","899","4295","135827","49801","2.73","1399","2992","51756","3.8","1955","140122"
"2214",123,1993,"2322","956","955","4452","141326","50639","2.79","1367","4289","52262","3.1","1623","145778"
"2215",123,1994,"2326","1158","945","4615","146753","51903","2.83","1381","4209","53274","2.6","1371","151368"
"2216",123,1995,"2224","1469","926","4556","152617","53305","2.86","1298","4507","54432","2.1","1127","157173"
"2217",123,1996,"2309","1854","1067","4699","157110","54788","2.87","1242","3394","55929","2","1141","161809"
"2218",123,1997,"2487","2114","1005","4729","162111","56803","2.85","1482","3549","57764","1.7","961","166840"
"2219",123,1998,"2599","3063","1062","4886","167508","58273","2.87","1537","4017","59950","2.8","1677","172394"
"2220",123,1999,"2841","3552","1096","5043","172222","63087","2.73","1745","3126","65316","3.4","2229","177265"
"2221",123,2000,"2998","1007","1053","4977","178099","64025","2.78","1945","3864","67366","5","3341","183076"
"2222",123,2001,"3245","4029","1210","5031","187451","67408","2.78","2035","7371","71809","6.1","4401","192482"
"2223",123,2002,"3447","4115","1178","5050","193925","69750","2.78","2269","4224","76236","8.5","6486","198975"
"2224",123,2003,"3651","4113","1224","5048","202109","72733","2.78","2427","5755","80488","9.6","7755","207157"
"2225",123,2004,"3895","3562","1217","5037","209032","75257","2.78","2678","4234","84557","11","9300","214069"
"2226",123,2005,"3849","3768","1263","5065","218367","78672","2.78","2586","6777","88602","11.2","9930","223432"
"2227",123,2006,"4001","3691","1259","5077","226206","81597","2.77","2742","5109","92059","11.4","10462","231283"
"2228",123,2007,"4101","2433","1314","5060","233219","84195","2.77","2787","4209","94523","10.9","10328","238279"
"2229",123,2008,"4013","1596","1294","5051","239065","86395","2.77","2719","3118","95692","9.7","9297","244116"
"2230",123,2009,"3923","837","1314","5057","243902","88253","2.76","2609","2234","96177","8.2","7924","248959"
"2231",123,2010,"3799","172","1352","5895","248335","89829","2.76","2447","2824","96540","7.1","6711","254230"
"2232",123,2011,"3751","705","1435","5872","252964","91483","2.77","2316","2290","97283","6.1","5800","258836"
"2233",123,2012,"3795","736","1456","5847","258275","93376","2.77","2339","2947","98182","4.9","4806","264122"
"2234",123,2013,"3815","1173","1566","5847","264317","95532","2.77","2249","3793","99434","3.9","3902","270164"
"2235",123,2014,"3961","1563","1611","4761","271283","97984","2.77","2350","3530","100895","2.9","2911","276044"
"2236",123,2015,"4083","2103","1732","5031","279996","100915","2.77","2351","6632","103164","2.2","2249","285027"
"2237",123,2016,"4256","2893","1751","5031","289836","104236","2.78","2505","7335","106088","1.7","1852","294867"
"2238",123,2017,"4309","3051","1832","5031","300057","107652","2.79","2477","7744","109225","1.5","1573","305088"
"2239",123,2018,"4271","3389","1880","5179","308990","111086","2.78","2391","6690","113086","1.9","2000","314169"
"2240",123,2019,"4243","3668","1870","5031","318732","114605","2.78","2373","7221","116710","1.9","2105","323763"
"2241",125,1985,"145","1","95","136","9717","3840","2.53","50","-132","4343","11.6","503","9853"
"2242",125,1986,"145","3","104","132","9451","3768","2.51","41","-311","4339","13.2","571","9583"
"2243",125,1987,"125","1","100","131","9303","3740","2.49","25","-174","4336","13.8","596","9434"
"2244",125,1988,"111","1","115","133","9431","3824","2.47","-4","134","4343","12","519","9564"
"2245",125,1989,"92","1","98","129","9082","3719","2.44","-6","-347","4300","13.5","581","9211"
"2246",125,1990,"139","1","93","121","8826","3472","2.54","46","-310","4082","14.9","610","8947"
"2247",125,1991,"128","1","91","121","8890","3494","2.54","37","27","4083","14.4","589","9011"
"2248",125,1992,"113","3","93","119","8882","3430","2.59","20","-30","4084","16","654","9001"
"2249",125,1993,"107","8","96","124","9042","3551","2.55","11","154","4092","13.2","541","9166"
"2250",125,1994,"98","8","83","124","9152","3596","2.55","15","95","4100","12.3","504","9276"
"2251",125,1995,"95","13","105","127","9328","3664","2.55","-10","189","4108","10.8","444","9455"
"2252",125,1996,"108","19","106","128","9393","3698","2.54","2","64","4121","10.3","423","9521"
"2253",125,1997,"128","10","114","130","9527","3780","2.52","14","122","4140","8.7","360","9657"
"2254",125,1998,"139","7","103","130","9669","3810","2.54","36","106","4150","8.2","340","9799"
"2255",125,1999,"141","14","99","130","9693","3844","2.52","42","-18","4250","9.6","406","9823"
"2256",125,2000,"92","4","91","135","9680","3791","2.55","1","-4","4301","11.9","510","9815"
"2257",125,2001,"144","17","114","146","9685","3802","2.55","30","-14","4329","12.2","527","9831"
"2258",125,2002,"119","11","115","210","9737","3834","2.54","4","112","4353","11.9","519","9947"
"2259",125,2003,"163","8","107","209","9884","3903","2.53","56","90","4372","10.7","469","10093"
"2260",125,2004,"140","9","104","207","9678","3830","2.53","36","-244","4392","12.8","562","9885"
"2261",125,2005,"142","2","105","205","9687","3843","2.52","37","-30","4406","12.8","563","9892"
"2262",125,2006,"153","1","112","216","9701","3857","2.52","41","-16","4417","12.7","560","9917"
"2263",125,2007,"148","5","89","221","9660","3850","2.51","59","-95","4435","13.2","585","9881"
"2264",125,2008,"159","0","121","219","9676","3866","2.5","38","-24","4446","13.1","580","9895"
"2265",125,2009,"166","4","90","217","9819","3934","2.5","76","65","4457","11.7","523","10036"
"2266",125,2010,"128","0","92","196","9836","3947","2.49","36","-40","4466","11.6","519","10032"
"2267",125,2011,"155","12","118","196","9921","3982","2.49","37","48","4476","11","494","10117"
"2268",125,2012,"157","10","112","196","9891","3970","2.49","45","-75","4485","11.5","515","10087"
"2269",125,2013,"140","9","92","233","9923","3982","2.49","48","21","4493","11.4","511","10156"
"2270",125,2014,"142","9","78","229","9975","4002","2.49","64","-16","4504","11.1","502","10204"
"2271",125,2015,"142","16","97","229","9832","3990","2.46","45","-188","4522","11.8","532","10061"
"2272",125,2016,"145","11","100","234","9843","3995","2.46","45","-29","4533","11.9","538","10077"
"2273",125,2017,"145","8","115","234","9756","3975","2.45","30","-117","4543","12.5","568","9990"
"2274",125,2018,"134","5","99","234","9739","3973","2.45","35","-52","4550","12.7","577","9973"
"2275",125,2019,"148","0","93","234","9829","3998","2.46","55","35","4556","12.2","558","10063"
